edQTL_GTEx_Adipose_Subcutaneous	/storage/yangjianLab/guoyazhou/GAMMA_github/gamma-script/scripts/L2G/MAGIC_data/QTL_lite_besd/besd/edQTL_GTEx_Adipose_Subcutaneous	FALSE
edQTL_GTEx_Adipose_Visceral_Omentum	/storage/yangjianLab/guoyazhou/GAMMA_github/gamma-script/scripts/L2G/MAGIC_data/QTL_lite_besd/besd/edQTL_GTEx_Adipose_Visceral_Omentum	FALSE
edQTL_GTEx_Adrenal_Gland	/storage/yangjianLab/guoyazhou/GAMMA_github/gamma-script/scripts/L2G/MAGIC_data/QTL_lite_besd/besd/edQTL_GTEx_Adrenal_Gland	FALSE
edQTL_GTEx_Artery_Aorta	/storage/yangjianLab/guoyazhou/GAMMA_github/gamma-script/scripts/L2G/MAGIC_data/QTL_lite_besd/besd/edQTL_GTEx_Artery_Aorta	FALSE
edQTL_GTEx_Artery_Coronary	/storage/yangjianLab/guoyazhou/GAMMA_github/gamma-script/scripts/L2G/MAGIC_data/QTL_lite_besd/besd/edQTL_GTEx_Artery_Coronary	FALSE
edQTL_GTEx_Artery_Tibial	/storage/yangjianLab/guoyazhou/GAMMA_github/gamma-script/scripts/L2G/MAGIC_data/QTL_lite_besd/besd/edQTL_GTEx_Artery_Tibial	FALSE
edQTL_GTEx_Brain_Amygdala	/storage/yangjianLab/guoyazhou/GAMMA_github/gamma-script/scripts/L2G/MAGIC_data/QTL_lite_besd/besd/edQTL_GTEx_Brain_Amygdala	FALSE
edQTL_GTEx_Brain_Anterior_cingulate_cortex_BA24	/storage/yangjianLab/guoyazhou/GAMMA_github/gamma-script/scripts/L2G/MAGIC_data/QTL_lite_besd/besd/edQTL_GTEx_Brain_Anterior_cingulate_cortex_BA24	FALSE
edQTL_GTEx_Brain_Caudate_basal_ganglia	/storage/yangjianLab/guoyazhou/GAMMA_github/gamma-script/scripts/L2G/MAGIC_data/QTL_lite_besd/besd/edQTL_GTEx_Brain_Caudate_basal_ganglia	FALSE
edQTL_GTEx_Brain_Cerebellar_Hemisphere	/storage/yangjianLab/guoyazhou/GAMMA_github/gamma-script/scripts/L2G/MAGIC_data/QTL_lite_besd/besd/edQTL_GTEx_Brain_Cerebellar_Hemisphere	FALSE
edQTL_GTEx_Brain_Cerebellum	/storage/yangjianLab/guoyazhou/GAMMA_github/gamma-script/scripts/L2G/MAGIC_data/QTL_lite_besd/besd/edQTL_GTEx_Brain_Cerebellum	FALSE
edQTL_GTEx_Brain_Cortex	/storage/yangjianLab/guoyazhou/GAMMA_github/gamma-script/scripts/L2G/MAGIC_data/QTL_lite_besd/besd/edQTL_GTEx_Brain_Cortex	FALSE
edQTL_GTEx_Brain_Frontal_Cortex_BA9	/storage/yangjianLab/guoyazhou/GAMMA_github/gamma-script/scripts/L2G/MAGIC_data/QTL_lite_besd/besd/edQTL_GTEx_Brain_Frontal_Cortex_BA9	FALSE
edQTL_GTEx_Brain_Hippocampus	/storage/yangjianLab/guoyazhou/GAMMA_github/gamma-script/scripts/L2G/MAGIC_data/QTL_lite_besd/besd/edQTL_GTEx_Brain_Hippocampus	FALSE
edQTL_GTEx_Brain_Hypothalamus	/storage/yangjianLab/guoyazhou/GAMMA_github/gamma-script/scripts/L2G/MAGIC_data/QTL_lite_besd/besd/edQTL_GTEx_Brain_Hypothalamus	FALSE
edQTL_GTEx_Brain_Nucleus_accumbens_basal_ganglia	/storage/yangjianLab/guoyazhou/GAMMA_github/gamma-script/scripts/L2G/MAGIC_data/QTL_lite_besd/besd/edQTL_GTEx_Brain_Nucleus_accumbens_basal_ganglia	FALSE
edQTL_GTEx_Brain_Putamen_basal_ganglia	/storage/yangjianLab/guoyazhou/GAMMA_github/gamma-script/scripts/L2G/MAGIC_data/QTL_lite_besd/besd/edQTL_GTEx_Brain_Putamen_basal_ganglia	FALSE
edQTL_GTEx_Brain_Spinal_cord_cervical_c-1	/storage/yangjianLab/guoyazhou/GAMMA_github/gamma-script/scripts/L2G/MAGIC_data/QTL_lite_besd/besd/edQTL_GTEx_Brain_Spinal_cord_cervical_c-1	FALSE
edQTL_GTEx_Brain_Substantia_nigra	/storage/yangjianLab/guoyazhou/GAMMA_github/gamma-script/scripts/L2G/MAGIC_data/QTL_lite_besd/besd/edQTL_GTEx_Brain_Substantia_nigra	FALSE
edQTL_GTEx_Breast_Mammary_Tissue	/storage/yangjianLab/guoyazhou/GAMMA_github/gamma-script/scripts/L2G/MAGIC_data/QTL_lite_besd/besd/edQTL_GTEx_Breast_Mammary_Tissue	FALSE
edQTL_GTEx_Cells_Cultured_fibroblasts	/storage/yangjianLab/guoyazhou/GAMMA_github/gamma-script/scripts/L2G/MAGIC_data/QTL_lite_besd/besd/edQTL_GTEx_Cells_Cultured_fibroblasts	FALSE
edQTL_GTEx_Cells_EBV-transformed_lymphocytes	/storage/yangjianLab/guoyazhou/GAMMA_github/gamma-script/scripts/L2G/MAGIC_data/QTL_lite_besd/besd/edQTL_GTEx_Cells_EBV-transformed_lymphocytes	FALSE
edQTL_GTEx_Colon_Sigmoid	/storage/yangjianLab/guoyazhou/GAMMA_github/gamma-script/scripts/L2G/MAGIC_data/QTL_lite_besd/besd/edQTL_GTEx_Colon_Sigmoid	FALSE
edQTL_GTEx_Colon_Transverse	/storage/yangjianLab/guoyazhou/GAMMA_github/gamma-script/scripts/L2G/MAGIC_data/QTL_lite_besd/besd/edQTL_GTEx_Colon_Transverse	FALSE
edQTL_GTEx_Esophagus_Gastroesophageal_Junction	/storage/yangjianLab/guoyazhou/GAMMA_github/gamma-script/scripts/L2G/MAGIC_data/QTL_lite_besd/besd/edQTL_GTEx_Esophagus_Gastroesophageal_Junction	FALSE
edQTL_GTEx_Esophagus_Mucosa	/storage/yangjianLab/guoyazhou/GAMMA_github/gamma-script/scripts/L2G/MAGIC_data/QTL_lite_besd/besd/edQTL_GTEx_Esophagus_Mucosa	FALSE
edQTL_GTEx_Esophagus_Muscularis	/storage/yangjianLab/guoyazhou/GAMMA_github/gamma-script/scripts/L2G/MAGIC_data/QTL_lite_besd/besd/edQTL_GTEx_Esophagus_Muscularis	FALSE
edQTL_GTEx_Heart_Atrial_Appendage	/storage/yangjianLab/guoyazhou/GAMMA_github/gamma-script/scripts/L2G/MAGIC_data/QTL_lite_besd/besd/edQTL_GTEx_Heart_Atrial_Appendage	FALSE
edQTL_GTEx_Heart_Left_Ventricle	/storage/yangjianLab/guoyazhou/GAMMA_github/gamma-script/scripts/L2G/MAGIC_data/QTL_lite_besd/besd/edQTL_GTEx_Heart_Left_Ventricle	FALSE
edQTL_GTEx_Kidney_Cortex	/storage/yangjianLab/guoyazhou/GAMMA_github/gamma-script/scripts/L2G/MAGIC_data/QTL_lite_besd/besd/edQTL_GTEx_Kidney_Cortex	FALSE
edQTL_GTEx_Liver	/storage/yangjianLab/guoyazhou/GAMMA_github/gamma-script/scripts/L2G/MAGIC_data/QTL_lite_besd/besd/edQTL_GTEx_Liver	FALSE
edQTL_GTEx_Lung	/storage/yangjianLab/guoyazhou/GAMMA_github/gamma-script/scripts/L2G/MAGIC_data/QTL_lite_besd/besd/edQTL_GTEx_Lung	FALSE
edQTL_GTEx_Minor_Salivary_Gland	/storage/yangjianLab/guoyazhou/GAMMA_github/gamma-script/scripts/L2G/MAGIC_data/QTL_lite_besd/besd/edQTL_GTEx_Minor_Salivary_Gland	FALSE
edQTL_GTEx_Muscle_Skeletal	/storage/yangjianLab/guoyazhou/GAMMA_github/gamma-script/scripts/L2G/MAGIC_data/QTL_lite_besd/besd/edQTL_GTEx_Muscle_Skeletal	FALSE
edQTL_GTEx_Nerve_Tibial	/storage/yangjianLab/guoyazhou/GAMMA_github/gamma-script/scripts/L2G/MAGIC_data/QTL_lite_besd/besd/edQTL_GTEx_Nerve_Tibial	FALSE
edQTL_GTEx_Ovary	/storage/yangjianLab/guoyazhou/GAMMA_github/gamma-script/scripts/L2G/MAGIC_data/QTL_lite_besd/besd/edQTL_GTEx_Ovary	FALSE
edQTL_GTEx_Pancreas	/storage/yangjianLab/guoyazhou/GAMMA_github/gamma-script/scripts/L2G/MAGIC_data/QTL_lite_besd/besd/edQTL_GTEx_Pancreas	FALSE
edQTL_GTEx_Pituitary	/storage/yangjianLab/guoyazhou/GAMMA_github/gamma-script/scripts/L2G/MAGIC_data/QTL_lite_besd/besd/edQTL_GTEx_Pituitary	FALSE
edQTL_GTEx_Prostate	/storage/yangjianLab/guoyazhou/GAMMA_github/gamma-script/scripts/L2G/MAGIC_data/QTL_lite_besd/besd/edQTL_GTEx_Prostate	FALSE
edQTL_GTEx_Skin_Not_Sun_Exposed_Suprapubic	/storage/yangjianLab/guoyazhou/GAMMA_github/gamma-script/scripts/L2G/MAGIC_data/QTL_lite_besd/besd/edQTL_GTEx_Skin_Not_Sun_Exposed_Suprapubic	FALSE
edQTL_GTEx_Skin_Sun_Exposed_Lower_leg	/storage/yangjianLab/guoyazhou/GAMMA_github/gamma-script/scripts/L2G/MAGIC_data/QTL_lite_besd/besd/edQTL_GTEx_Skin_Sun_Exposed_Lower_leg	FALSE
edQTL_GTEx_Small_Intestine_Terminal_Ileum	/storage/yangjianLab/guoyazhou/GAMMA_github/gamma-script/scripts/L2G/MAGIC_data/QTL_lite_besd/besd/edQTL_GTEx_Small_Intestine_Terminal_Ileum	FALSE
edQTL_GTEx_Spleen	/storage/yangjianLab/guoyazhou/GAMMA_github/gamma-script/scripts/L2G/MAGIC_data/QTL_lite_besd/besd/edQTL_GTEx_Spleen	FALSE
edQTL_GTEx_Stomach	/storage/yangjianLab/guoyazhou/GAMMA_github/gamma-script/scripts/L2G/MAGIC_data/QTL_lite_besd/besd/edQTL_GTEx_Stomach	FALSE
edQTL_GTEx_Testis	/storage/yangjianLab/guoyazhou/GAMMA_github/gamma-script/scripts/L2G/MAGIC_data/QTL_lite_besd/besd/edQTL_GTEx_Testis	FALSE
edQTL_GTEx_Thyroid	/storage/yangjianLab/guoyazhou/GAMMA_github/gamma-script/scripts/L2G/MAGIC_data/QTL_lite_besd/besd/edQTL_GTEx_Thyroid	FALSE
edQTL_GTEx_Uterus	/storage/yangjianLab/guoyazhou/GAMMA_github/gamma-script/scripts/L2G/MAGIC_data/QTL_lite_besd/besd/edQTL_GTEx_Uterus	FALSE
edQTL_GTEx_Vagina	/storage/yangjianLab/guoyazhou/GAMMA_github/gamma-script/scripts/L2G/MAGIC_data/QTL_lite_besd/besd/edQTL_GTEx_Vagina	FALSE
edQTL_GTEx_Whole_Blood	/storage/yangjianLab/guoyazhou/GAMMA_github/gamma-script/scripts/L2G/MAGIC_data/QTL_lite_besd/besd/edQTL_GTEx_Whole_Blood	FALSE