eQTL_eQTLGen	/storage/yangjianLab/guoyazhou/GAMMA_github/gamma-script/scripts/L2G/MAGIC_data/QTL_lite_besd/besd/eQTL_eQTLGen	FALSE
eQTL_Microglia_Regulome	/storage/yangjianLab/guoyazhou/GAMMA_github/gamma-script/scripts/L2G/MAGIC_data/QTL_lite_besd/besd/eQTL_Microglia_Regulome	TRUE
eQTL_Adipose	/storage/yangjianLab/guoyazhou/GAMMA_github/gamma-script/scripts/L2G/MAGIC_data/QTL_lite_besd/besd/eQTL_Adipose	TRUE
eQTL_Adipose_Brotman_2025_NG	/storage/yangjianLab/guoyazhou/GAMMA_github/gamma-script/scripts/L2G/MAGIC_data/QTL_lite_besd/besd/eQTL_Adipose_Brotman_2025_NG	TRUE
eQTL_DIRECT	/storage/yangjianLab/guoyazhou/GAMMA_github/gamma-script/scripts/L2G/MAGIC_data/QTL_lite_besd/besd/eQTL_DIRECT	FALSE
eQTL_INTERVAL	/storage/yangjianLab/guoyazhou/GAMMA_github/gamma-script/scripts/L2G/MAGIC_data/QTL_lite_besd/besd/eQTL_INTERVAL	TRUE
eQTL_BrainMeta	/storage/yangjianLab/guoyazhou/GAMMA_github/gamma-script/scripts/L2G/MAGIC_data/QTL_lite_besd/besd/eQTL_BrainMeta	TRUE
eQTL_Microglia	/storage/yangjianLab/guoyazhou/GAMMA_github/gamma-script/scripts/L2G/MAGIC_data/QTL_lite_besd/besd/eQTL_Microglia	FALSE
eQTL_Fetal_Brain	/storage/yangjianLab/guoyazhou/GAMMA_github/gamma-script/scripts/L2G/MAGIC_data/QTL_lite_besd/besd/eQTL_Fetal_Brain	FALSE
eQTL_PEC_Tri1	/storage/yangjianLab/guoyazhou/GAMMA_github/gamma-script/scripts/L2G/MAGIC_data/QTL_lite_besd/besd/eQTL_PEC_Tri1	TRUE
eQTL_PEC_Tri2	/storage/yangjianLab/guoyazhou/GAMMA_github/gamma-script/scripts/L2G/MAGIC_data/QTL_lite_besd/besd/eQTL_PEC_Tri2	TRUE
eQTL_Perez_2022_B	/storage/yangjianLab/guoyazhou/GAMMA_github/gamma-script/scripts/L2G/MAGIC_data/QTL_lite_besd/besd/eQTL_Perez_2022_B	FALSE
eQTL_Perez_2022_cDC	/storage/yangjianLab/guoyazhou/GAMMA_github/gamma-script/scripts/L2G/MAGIC_data/QTL_lite_besd/besd/eQTL_Perez_2022_cDC	FALSE
eQTL_Perez_2022_cM	/storage/yangjianLab/guoyazhou/GAMMA_github/gamma-script/scripts/L2G/MAGIC_data/QTL_lite_besd/besd/eQTL_Perez_2022_cM	FALSE
eQTL_Perez_2022_ncM	/storage/yangjianLab/guoyazhou/GAMMA_github/gamma-script/scripts/L2G/MAGIC_data/QTL_lite_besd/besd/eQTL_Perez_2022_ncM	FALSE
eQTL_Perez_2022_NK	/storage/yangjianLab/guoyazhou/GAMMA_github/gamma-script/scripts/L2G/MAGIC_data/QTL_lite_besd/besd/eQTL_Perez_2022_NK	FALSE
eQTL_Perez_2022_pDC	/storage/yangjianLab/guoyazhou/GAMMA_github/gamma-script/scripts/L2G/MAGIC_data/QTL_lite_besd/besd/eQTL_Perez_2022_pDC	FALSE
eQTL_Perez_2022_Prolif	/storage/yangjianLab/guoyazhou/GAMMA_github/gamma-script/scripts/L2G/MAGIC_data/QTL_lite_besd/besd/eQTL_Perez_2022_Prolif	FALSE
eQTL_Perez_2022_T4	/storage/yangjianLab/guoyazhou/GAMMA_github/gamma-script/scripts/L2G/MAGIC_data/QTL_lite_besd/besd/eQTL_Perez_2022_T4	FALSE
eQTL_Perez_2022_T8	/storage/yangjianLab/guoyazhou/GAMMA_github/gamma-script/scripts/L2G/MAGIC_data/QTL_lite_besd/besd/eQTL_Perez_2022_T8	FALSE
eQTL_Jerber_2021_Astro_Naive_D52	/storage/yangjianLab/guoyazhou/GAMMA_github/gamma-script/scripts/L2G/MAGIC_data/QTL_lite_besd/besd/eQTL_Jerber_2021_Astro_Naive_D52	FALSE
eQTL_Jerber_2021_Astro_ROT_D52	/storage/yangjianLab/guoyazhou/GAMMA_github/gamma-script/scripts/L2G/MAGIC_data/QTL_lite_besd/besd/eQTL_Jerber_2021_Astro_ROT_D52	FALSE
eQTL_Jerber_2021_DA_Naive_D30	/storage/yangjianLab/guoyazhou/GAMMA_github/gamma-script/scripts/L2G/MAGIC_data/QTL_lite_besd/besd/eQTL_Jerber_2021_DA_Naive_D30	FALSE
eQTL_Jerber_2021_DA_Naive_D52	/storage/yangjianLab/guoyazhou/GAMMA_github/gamma-script/scripts/L2G/MAGIC_data/QTL_lite_besd/besd/eQTL_Jerber_2021_DA_Naive_D52	FALSE
eQTL_Jerber_2021_DA_ROT_D52	/storage/yangjianLab/guoyazhou/GAMMA_github/gamma-script/scripts/L2G/MAGIC_data/QTL_lite_besd/besd/eQTL_Jerber_2021_DA_ROT_D52	FALSE
eQTL_Jerber_2021_Epen1_Naive_D30	/storage/yangjianLab/guoyazhou/GAMMA_github/gamma-script/scripts/L2G/MAGIC_data/QTL_lite_besd/besd/eQTL_Jerber_2021_Epen1_Naive_D30	FALSE
eQTL_Jerber_2021_Epen1_Naive_D52	/storage/yangjianLab/guoyazhou/GAMMA_github/gamma-script/scripts/L2G/MAGIC_data/QTL_lite_besd/besd/eQTL_Jerber_2021_Epen1_Naive_D52	FALSE
eQTL_Jerber_2021_Epen1_ROT_D52	/storage/yangjianLab/guoyazhou/GAMMA_github/gamma-script/scripts/L2G/MAGIC_data/QTL_lite_besd/besd/eQTL_Jerber_2021_Epen1_ROT_D52	FALSE
eQTL_Jerber_2021_Epen2_Naive_D52	/storage/yangjianLab/guoyazhou/GAMMA_github/gamma-script/scripts/L2G/MAGIC_data/QTL_lite_besd/besd/eQTL_Jerber_2021_Epen2_Naive_D52	FALSE
eQTL_Jerber_2021_Epen2_ROT_D52	/storage/yangjianLab/guoyazhou/GAMMA_github/gamma-script/scripts/L2G/MAGIC_data/QTL_lite_besd/besd/eQTL_Jerber_2021_Epen2_ROT_D52	FALSE
eQTL_Jerber_2021_FPP_Naive_D11	/storage/yangjianLab/guoyazhou/GAMMA_github/gamma-script/scripts/L2G/MAGIC_data/QTL_lite_besd/besd/eQTL_Jerber_2021_FPP_Naive_D11	FALSE
eQTL_Jerber_2021_FPP_Naive_D30	/storage/yangjianLab/guoyazhou/GAMMA_github/gamma-script/scripts/L2G/MAGIC_data/QTL_lite_besd/besd/eQTL_Jerber_2021_FPP_Naive_D30	FALSE
eQTL_Jerber_2021_FPP_Naive_D52	/storage/yangjianLab/guoyazhou/GAMMA_github/gamma-script/scripts/L2G/MAGIC_data/QTL_lite_besd/besd/eQTL_Jerber_2021_FPP_Naive_D52	FALSE
eQTL_Jerber_2021_FPP_ROT_D52	/storage/yangjianLab/guoyazhou/GAMMA_github/gamma-script/scripts/L2G/MAGIC_data/QTL_lite_besd/besd/eQTL_Jerber_2021_FPP_ROT_D52	FALSE
eQTL_Jerber_2021_NB_Naive_D11	/storage/yangjianLab/guoyazhou/GAMMA_github/gamma-script/scripts/L2G/MAGIC_data/QTL_lite_besd/besd/eQTL_Jerber_2021_NB_Naive_D11	FALSE
eQTL_Jerber_2021_P_FPP_Naive_D11	/storage/yangjianLab/guoyazhou/GAMMA_github/gamma-script/scripts/L2G/MAGIC_data/QTL_lite_besd/besd/eQTL_Jerber_2021_P_FPP_Naive_D11	FALSE
eQTL_Jerber_2021_P_FPP_Naive_D30	/storage/yangjianLab/guoyazhou/GAMMA_github/gamma-script/scripts/L2G/MAGIC_data/QTL_lite_besd/besd/eQTL_Jerber_2021_P_FPP_Naive_D30	FALSE
eQTL_Jerber_2021_P_FPP_Naive_D52	/storage/yangjianLab/guoyazhou/GAMMA_github/gamma-script/scripts/L2G/MAGIC_data/QTL_lite_besd/besd/eQTL_Jerber_2021_P_FPP_Naive_D52	FALSE
eQTL_Jerber_2021_P_FPP_ROT_D52	/storage/yangjianLab/guoyazhou/GAMMA_github/gamma-script/scripts/L2G/MAGIC_data/QTL_lite_besd/besd/eQTL_Jerber_2021_P_FPP_ROT_D52	FALSE
eQTL_Jerber_2021_P_Sert_Naive_D52	/storage/yangjianLab/guoyazhou/GAMMA_github/gamma-script/scripts/L2G/MAGIC_data/QTL_lite_besd/besd/eQTL_Jerber_2021_P_Sert_Naive_D52	FALSE
eQTL_Jerber_2021_P_Sert_ROT_D52	/storage/yangjianLab/guoyazhou/GAMMA_github/gamma-script/scripts/L2G/MAGIC_data/QTL_lite_besd/besd/eQTL_Jerber_2021_P_Sert_ROT_D52	FALSE
eQTL_Jerber_2021_Sert_Naive_D30	/storage/yangjianLab/guoyazhou/GAMMA_github/gamma-script/scripts/L2G/MAGIC_data/QTL_lite_besd/besd/eQTL_Jerber_2021_Sert_Naive_D30	FALSE
eQTL_Jerber_2021_Sert_Naive_D52	/storage/yangjianLab/guoyazhou/GAMMA_github/gamma-script/scripts/L2G/MAGIC_data/QTL_lite_besd/besd/eQTL_Jerber_2021_Sert_Naive_D52	FALSE
eQTL_Jerber_2021_Sert_ROT_D52	/storage/yangjianLab/guoyazhou/GAMMA_github/gamma-script/scripts/L2G/MAGIC_data/QTL_lite_besd/besd/eQTL_Jerber_2021_Sert_ROT_D52	FALSE
eQTL_Jerber_2021_U_Neur1_Naive_D30	/storage/yangjianLab/guoyazhou/GAMMA_github/gamma-script/scripts/L2G/MAGIC_data/QTL_lite_besd/besd/eQTL_Jerber_2021_U_Neur1_Naive_D30	FALSE
eQTL_Jerber_2021_U_Neur1_Naive_D52	/storage/yangjianLab/guoyazhou/GAMMA_github/gamma-script/scripts/L2G/MAGIC_data/QTL_lite_besd/besd/eQTL_Jerber_2021_U_Neur1_Naive_D52	FALSE
eQTL_Jerber_2021_U_Neur1_ROT_D52	/storage/yangjianLab/guoyazhou/GAMMA_github/gamma-script/scripts/L2G/MAGIC_data/QTL_lite_besd/besd/eQTL_Jerber_2021_U_Neur1_ROT_D52	FALSE
eQTL_Jerber_2021_U_Neur2_Naive_D30	/storage/yangjianLab/guoyazhou/GAMMA_github/gamma-script/scripts/L2G/MAGIC_data/QTL_lite_besd/besd/eQTL_Jerber_2021_U_Neur2_Naive_D30	FALSE
eQTL_Jerber_2021_U_Neur3_Naive_D52	/storage/yangjianLab/guoyazhou/GAMMA_github/gamma-script/scripts/L2G/MAGIC_data/QTL_lite_besd/besd/eQTL_Jerber_2021_U_Neur3_Naive_D52	FALSE
eQTL_Jerber_2021_U_Neur3_ROT_D52	/storage/yangjianLab/guoyazhou/GAMMA_github/gamma-script/scripts/L2G/MAGIC_data/QTL_lite_besd/besd/eQTL_Jerber_2021_U_Neur3_ROT_D52	FALSE
eQTL_Nathan_2022_CD4-8+_PD-1+TIGIT+	/storage/yangjianLab/guoyazhou/GAMMA_github/gamma-script/scripts/L2G/MAGIC_data/QTL_lite_besd/besd/eQTL_Nathan_2022_CD4-8+_PD-1+TIGIT+	FALSE
eQTL_Nathan_2022_CD4+_activated	/storage/yangjianLab/guoyazhou/GAMMA_github/gamma-script/scripts/L2G/MAGIC_data/QTL_lite_besd/besd/eQTL_Nathan_2022_CD4+_activated	FALSE
eQTL_Nathan_2022_CD4+_CCR4+_central	/storage/yangjianLab/guoyazhou/GAMMA_github/gamma-script/scripts/L2G/MAGIC_data/QTL_lite_besd/besd/eQTL_Nathan_2022_CD4+_CCR4+_central	FALSE
eQTL_Nathan_2022_CD4+_CCR4+ICOS+_central	/storage/yangjianLab/guoyazhou/GAMMA_github/gamma-script/scripts/L2G/MAGIC_data/QTL_lite_besd/besd/eQTL_Nathan_2022_CD4+_CCR4+ICOS+_central	FALSE
eQTL_Nathan_2022_CD4+_CCR4+	/storage/yangjianLab/guoyazhou/GAMMA_github/gamma-script/scripts/L2G/MAGIC_data/QTL_lite_besd/besd/eQTL_Nathan_2022_CD4+_CCR4+	FALSE
eQTL_Nathan_2022_CD4+_CCR5+_cytotoxic	/storage/yangjianLab/guoyazhou/GAMMA_github/gamma-script/scripts/L2G/MAGIC_data/QTL_lite_besd/besd/eQTL_Nathan_2022_CD4+_CCR5+_cytotoxic	FALSE
eQTL_Nathan_2022_CD4+_CD161+_cytotoxic	/storage/yangjianLab/guoyazhou/GAMMA_github/gamma-script/scripts/L2G/MAGIC_data/QTL_lite_besd/besd/eQTL_Nathan_2022_CD4+_CD161+_cytotoxic	FALSE
eQTL_Nathan_2022_CD4+_CD161+_Th1	/storage/yangjianLab/guoyazhou/GAMMA_github/gamma-script/scripts/L2G/MAGIC_data/QTL_lite_besd/besd/eQTL_Nathan_2022_CD4+_CD161+_Th1	FALSE
eQTL_Nathan_2022_CD4+_CD161+_Th2	/storage/yangjianLab/guoyazhou/GAMMA_github/gamma-script/scripts/L2G/MAGIC_data/QTL_lite_besd/besd/eQTL_Nathan_2022_CD4+_CD161+_Th2	FALSE
eQTL_Nathan_2022_CD4+_CD27+CD161+	/storage/yangjianLab/guoyazhou/GAMMA_github/gamma-script/scripts/L2G/MAGIC_data/QTL_lite_besd/besd/eQTL_Nathan_2022_CD4+_CD27+CD161+	FALSE
eQTL_Nathan_2022_CD4+_CD27+	/storage/yangjianLab/guoyazhou/GAMMA_github/gamma-script/scripts/L2G/MAGIC_data/QTL_lite_besd/besd/eQTL_Nathan_2022_CD4+_CD27+	FALSE
eQTL_Nathan_2022_CD4+_CD38+ICOS+_central	/storage/yangjianLab/guoyazhou/GAMMA_github/gamma-script/scripts/L2G/MAGIC_data/QTL_lite_besd/besd/eQTL_Nathan_2022_CD4+_CD38+ICOS+_central	FALSE
eQTL_Nathan_2022_CD4+_central	/storage/yangjianLab/guoyazhou/GAMMA_github/gamma-script/scripts/L2G/MAGIC_data/QTL_lite_besd/besd/eQTL_Nathan_2022_CD4+_central	FALSE
eQTL_Nathan_2022_CD4+_cytotoxic	/storage/yangjianLab/guoyazhou/GAMMA_github/gamma-script/scripts/L2G/MAGIC_data/QTL_lite_besd/besd/eQTL_Nathan_2022_CD4+_cytotoxic	FALSE
eQTL_Nathan_2022_CD4+_HLA-DR+	/storage/yangjianLab/guoyazhou/GAMMA_github/gamma-script/scripts/L2G/MAGIC_data/QTL_lite_besd/besd/eQTL_Nathan_2022_CD4+_HLA-DR+	FALSE
eQTL_Nathan_2022_CD4+_lncRNA	/storage/yangjianLab/guoyazhou/GAMMA_github/gamma-script/scripts/L2G/MAGIC_data/QTL_lite_besd/besd/eQTL_Nathan_2022_CD4+_lncRNA	FALSE
eQTL_Nathan_2022_CD4+_RORC+_Treg	/storage/yangjianLab/guoyazhou/GAMMA_github/gamma-script/scripts/L2G/MAGIC_data/QTL_lite_besd/besd/eQTL_Nathan_2022_CD4+_RORC+_Treg	FALSE
eQTL_Nathan_2022_CD4+_Th17-1	/storage/yangjianLab/guoyazhou/GAMMA_github/gamma-script/scripts/L2G/MAGIC_data/QTL_lite_besd/besd/eQTL_Nathan_2022_CD4+_Th17-1	FALSE
eQTL_Nathan_2022_CD4+_Th17	/storage/yangjianLab/guoyazhou/GAMMA_github/gamma-script/scripts/L2G/MAGIC_data/QTL_lite_besd/besd/eQTL_Nathan_2022_CD4+_Th17	FALSE
eQTL_Nathan_2022_CD4+_Th1	/storage/yangjianLab/guoyazhou/GAMMA_github/gamma-script/scripts/L2G/MAGIC_data/QTL_lite_besd/besd/eQTL_Nathan_2022_CD4+_Th1	FALSE
eQTL_Nathan_2022_CD4+_Th2	/storage/yangjianLab/guoyazhou/GAMMA_github/gamma-script/scripts/L2G/MAGIC_data/QTL_lite_besd/besd/eQTL_Nathan_2022_CD4+_Th2	FALSE
eQTL_Nathan_2022_CD4+_Treg	/storage/yangjianLab/guoyazhou/GAMMA_github/gamma-script/scripts/L2G/MAGIC_data/QTL_lite_besd/besd/eQTL_Nathan_2022_CD4+_Treg	FALSE
eQTL_Nathan_2022_CD8+_activated	/storage/yangjianLab/guoyazhou/GAMMA_github/gamma-script/scripts/L2G/MAGIC_data/QTL_lite_besd/besd/eQTL_Nathan_2022_CD8+_activated	FALSE
eQTL_Nathan_2022_CD8+_central	/storage/yangjianLab/guoyazhou/GAMMA_github/gamma-script/scripts/L2G/MAGIC_data/QTL_lite_besd/besd/eQTL_Nathan_2022_CD8+_central	FALSE
eQTL_Nathan_2022_CD8+_CXCR3+	/storage/yangjianLab/guoyazhou/GAMMA_github/gamma-script/scripts/L2G/MAGIC_data/QTL_lite_besd/besd/eQTL_Nathan_2022_CD8+_CXCR3+	FALSE
eQTL_Nathan_2022_CD8+_GZMB+	/storage/yangjianLab/guoyazhou/GAMMA_github/gamma-script/scripts/L2G/MAGIC_data/QTL_lite_besd/besd/eQTL_Nathan_2022_CD8+_GZMB+	FALSE
eQTL_Nathan_2022_CD8+_GZMK+	/storage/yangjianLab/guoyazhou/GAMMA_github/gamma-script/scripts/L2G/MAGIC_data/QTL_lite_besd/besd/eQTL_Nathan_2022_CD8+_GZMK+	FALSE
eQTL_Nathan_2022_Vd1	/storage/yangjianLab/guoyazhou/GAMMA_github/gamma-script/scripts/L2G/MAGIC_data/QTL_lite_besd/besd/eQTL_Nathan_2022_Vd1	FALSE
eQTL_Nathan_2022_Vd2	/storage/yangjianLab/guoyazhou/GAMMA_github/gamma-script/scripts/L2G/MAGIC_data/QTL_lite_besd/besd/eQTL_Nathan_2022_Vd2	FALSE
eQTL_Cytoimmgen_combined_CD4_Memory_STIM_16H	/storage/yangjianLab/guoyazhou/GAMMA_github/gamma-script/scripts/L2G/MAGIC_data/QTL_lite_besd/besd/eQTL_Cytoimmgen_combined_CD4_Memory_STIM_16H	FALSE
eQTL_Cytoimmgen_combined_CD4_Memory_STIM_40H	/storage/yangjianLab/guoyazhou/GAMMA_github/gamma-script/scripts/L2G/MAGIC_data/QTL_lite_besd/besd/eQTL_Cytoimmgen_combined_CD4_Memory_STIM_40H	FALSE
eQTL_Cytoimmgen_combined_CD4_Memory_STIM_5D	/storage/yangjianLab/guoyazhou/GAMMA_github/gamma-script/scripts/L2G/MAGIC_data/QTL_lite_besd/besd/eQTL_Cytoimmgen_combined_CD4_Memory_STIM_5D	FALSE
eQTL_Cytoimmgen_combined_CD4_Memory_UNS_16H	/storage/yangjianLab/guoyazhou/GAMMA_github/gamma-script/scripts/L2G/MAGIC_data/QTL_lite_besd/besd/eQTL_Cytoimmgen_combined_CD4_Memory_UNS_16H	FALSE
eQTL_Cytoimmgen_combined_CD4_Naive_STIM_16H	/storage/yangjianLab/guoyazhou/GAMMA_github/gamma-script/scripts/L2G/MAGIC_data/QTL_lite_besd/besd/eQTL_Cytoimmgen_combined_CD4_Naive_STIM_16H	FALSE
eQTL_Cytoimmgen_combined_CD4_Naive_STIM_40H	/storage/yangjianLab/guoyazhou/GAMMA_github/gamma-script/scripts/L2G/MAGIC_data/QTL_lite_besd/besd/eQTL_Cytoimmgen_combined_CD4_Naive_STIM_40H	FALSE
eQTL_Cytoimmgen_combined_CD4_Naive_STIM_5D	/storage/yangjianLab/guoyazhou/GAMMA_github/gamma-script/scripts/L2G/MAGIC_data/QTL_lite_besd/besd/eQTL_Cytoimmgen_combined_CD4_Naive_STIM_5D	FALSE
eQTL_Cytoimmgen_combined_CD4_Naive_UNS_16H	/storage/yangjianLab/guoyazhou/GAMMA_github/gamma-script/scripts/L2G/MAGIC_data/QTL_lite_besd/besd/eQTL_Cytoimmgen_combined_CD4_Naive_UNS_16H	FALSE
eQTL_Cytoimmgen_HSP_STIM_16H	/storage/yangjianLab/guoyazhou/GAMMA_github/gamma-script/scripts/L2G/MAGIC_data/QTL_lite_besd/besd/eQTL_Cytoimmgen_HSP_STIM_16H	FALSE
eQTL_Cytoimmgen_nTreg_STIM_16H	/storage/yangjianLab/guoyazhou/GAMMA_github/gamma-script/scripts/L2G/MAGIC_data/QTL_lite_besd/besd/eQTL_Cytoimmgen_nTreg_STIM_16H	FALSE
eQTL_Cytoimmgen_nTreg_STIM_40H	/storage/yangjianLab/guoyazhou/GAMMA_github/gamma-script/scripts/L2G/MAGIC_data/QTL_lite_besd/besd/eQTL_Cytoimmgen_nTreg_STIM_40H	FALSE
eQTL_Cytoimmgen_nTreg_UNS_16H	/storage/yangjianLab/guoyazhou/GAMMA_github/gamma-script/scripts/L2G/MAGIC_data/QTL_lite_besd/besd/eQTL_Cytoimmgen_nTreg_UNS_16H	FALSE
eQTL_Cytoimmgen_TCM1_Lowly_Active_STIM_16H	/storage/yangjianLab/guoyazhou/GAMMA_github/gamma-script/scripts/L2G/MAGIC_data/QTL_lite_besd/besd/eQTL_Cytoimmgen_TCM1_Lowly_Active_STIM_16H	FALSE
eQTL_Cytoimmgen_TCM1_Lowly_Active_STIM_40H	/storage/yangjianLab/guoyazhou/GAMMA_github/gamma-script/scripts/L2G/MAGIC_data/QTL_lite_besd/besd/eQTL_Cytoimmgen_TCM1_Lowly_Active_STIM_40H	FALSE
eQTL_Cytoimmgen_TCM2_Lowly_Active_STIM_16H	/storage/yangjianLab/guoyazhou/GAMMA_github/gamma-script/scripts/L2G/MAGIC_data/QTL_lite_besd/besd/eQTL_Cytoimmgen_TCM2_Lowly_Active_STIM_16H	FALSE
eQTL_Cytoimmgen_TCM2_Lowly_Active_STIM_40H	/storage/yangjianLab/guoyazhou/GAMMA_github/gamma-script/scripts/L2G/MAGIC_data/QTL_lite_besd/besd/eQTL_Cytoimmgen_TCM2_Lowly_Active_STIM_40H	FALSE
eQTL_Cytoimmgen_TCM_STIM_16H	/storage/yangjianLab/guoyazhou/GAMMA_github/gamma-script/scripts/L2G/MAGIC_data/QTL_lite_besd/besd/eQTL_Cytoimmgen_TCM_STIM_16H	FALSE
eQTL_Cytoimmgen_TCM_STIM_40H	/storage/yangjianLab/guoyazhou/GAMMA_github/gamma-script/scripts/L2G/MAGIC_data/QTL_lite_besd/besd/eQTL_Cytoimmgen_TCM_STIM_40H	FALSE
eQTL_Cytoimmgen_TCM_STIM_5D	/storage/yangjianLab/guoyazhou/GAMMA_github/gamma-script/scripts/L2G/MAGIC_data/QTL_lite_besd/besd/eQTL_Cytoimmgen_TCM_STIM_5D	FALSE
eQTL_Cytoimmgen_TCM_UNS_16H	/storage/yangjianLab/guoyazhou/GAMMA_github/gamma-script/scripts/L2G/MAGIC_data/QTL_lite_besd/besd/eQTL_Cytoimmgen_TCM_UNS_16H	FALSE
eQTL_Cytoimmgen_TEM_HLA+_STIM_40H	/storage/yangjianLab/guoyazhou/GAMMA_github/gamma-script/scripts/L2G/MAGIC_data/QTL_lite_besd/besd/eQTL_Cytoimmgen_TEM_HLA+_STIM_40H	FALSE
eQTL_Cytoimmgen_TEM_HLA+_STIM_5D	/storage/yangjianLab/guoyazhou/GAMMA_github/gamma-script/scripts/L2G/MAGIC_data/QTL_lite_besd/besd/eQTL_Cytoimmgen_TEM_HLA+_STIM_5D	FALSE
eQTL_Cytoimmgen_TEM_Lowly_Active_STIM_16H	/storage/yangjianLab/guoyazhou/GAMMA_github/gamma-script/scripts/L2G/MAGIC_data/QTL_lite_besd/besd/eQTL_Cytoimmgen_TEM_Lowly_Active_STIM_16H	FALSE
eQTL_Cytoimmgen_TEM_Lowly_Active_STIM_40H	/storage/yangjianLab/guoyazhou/GAMMA_github/gamma-script/scripts/L2G/MAGIC_data/QTL_lite_besd/besd/eQTL_Cytoimmgen_TEM_Lowly_Active_STIM_40H	FALSE
eQTL_Cytoimmgen_TEMRA_Lowly_Active_STIM_16H	/storage/yangjianLab/guoyazhou/GAMMA_github/gamma-script/scripts/L2G/MAGIC_data/QTL_lite_besd/besd/eQTL_Cytoimmgen_TEMRA_Lowly_Active_STIM_16H	FALSE
eQTL_Cytoimmgen_TEMRA_STIM_16H	/storage/yangjianLab/guoyazhou/GAMMA_github/gamma-script/scripts/L2G/MAGIC_data/QTL_lite_besd/besd/eQTL_Cytoimmgen_TEMRA_STIM_16H	FALSE
eQTL_Cytoimmgen_TEMRA_STIM_40H	/storage/yangjianLab/guoyazhou/GAMMA_github/gamma-script/scripts/L2G/MAGIC_data/QTL_lite_besd/besd/eQTL_Cytoimmgen_TEMRA_STIM_40H	FALSE
eQTL_Cytoimmgen_TEMRA_STIM_5D	/storage/yangjianLab/guoyazhou/GAMMA_github/gamma-script/scripts/L2G/MAGIC_data/QTL_lite_besd/besd/eQTL_Cytoimmgen_TEMRA_STIM_5D	FALSE
eQTL_Cytoimmgen_TEMRA_UNS_16H	/storage/yangjianLab/guoyazhou/GAMMA_github/gamma-script/scripts/L2G/MAGIC_data/QTL_lite_besd/besd/eQTL_Cytoimmgen_TEMRA_UNS_16H	FALSE
eQTL_Cytoimmgen_TEM_STIM_16H	/storage/yangjianLab/guoyazhou/GAMMA_github/gamma-script/scripts/L2G/MAGIC_data/QTL_lite_besd/besd/eQTL_Cytoimmgen_TEM_STIM_16H	FALSE
eQTL_Cytoimmgen_TEM_STIM_40H	/storage/yangjianLab/guoyazhou/GAMMA_github/gamma-script/scripts/L2G/MAGIC_data/QTL_lite_besd/besd/eQTL_Cytoimmgen_TEM_STIM_40H	FALSE
eQTL_Cytoimmgen_TEM_STIM_5D	/storage/yangjianLab/guoyazhou/GAMMA_github/gamma-script/scripts/L2G/MAGIC_data/QTL_lite_besd/besd/eQTL_Cytoimmgen_TEM_STIM_5D	FALSE
eQTL_Cytoimmgen_TEM_UNS_16H	/storage/yangjianLab/guoyazhou/GAMMA_github/gamma-script/scripts/L2G/MAGIC_data/QTL_lite_besd/besd/eQTL_Cytoimmgen_TEM_UNS_16H	FALSE
eQTL_Cytoimmgen_T_ER-stress_STIM_5D	/storage/yangjianLab/guoyazhou/GAMMA_github/gamma-script/scripts/L2G/MAGIC_data/QTL_lite_besd/besd/eQTL_Cytoimmgen_T_ER-stress_STIM_5D	FALSE
eQTL_Cytoimmgen_TM_cycling_STIM_5D	/storage/yangjianLab/guoyazhou/GAMMA_github/gamma-script/scripts/L2G/MAGIC_data/QTL_lite_besd/besd/eQTL_Cytoimmgen_TM_cycling_STIM_5D	FALSE
eQTL_Cytoimmgen_TM_ER-stress_STIM_40H	/storage/yangjianLab/guoyazhou/GAMMA_github/gamma-script/scripts/L2G/MAGIC_data/QTL_lite_besd/besd/eQTL_Cytoimmgen_TM_ER-stress_STIM_40H	FALSE
eQTL_Cytoimmgen_TN1_Lowly_Active_STIM_16H	/storage/yangjianLab/guoyazhou/GAMMA_github/gamma-script/scripts/L2G/MAGIC_data/QTL_lite_besd/besd/eQTL_Cytoimmgen_TN1_Lowly_Active_STIM_16H	FALSE
eQTL_Cytoimmgen_TN1_Lowly_Active_STIM_40H	/storage/yangjianLab/guoyazhou/GAMMA_github/gamma-script/scripts/L2G/MAGIC_data/QTL_lite_besd/besd/eQTL_Cytoimmgen_TN1_Lowly_Active_STIM_40H	FALSE
eQTL_Cytoimmgen_TN1_STIM_40H	/storage/yangjianLab/guoyazhou/GAMMA_github/gamma-script/scripts/L2G/MAGIC_data/QTL_lite_besd/besd/eQTL_Cytoimmgen_TN1_STIM_40H	FALSE
eQTL_Cytoimmgen_TN1_UNS_16H	/storage/yangjianLab/guoyazhou/GAMMA_github/gamma-script/scripts/L2G/MAGIC_data/QTL_lite_besd/besd/eQTL_Cytoimmgen_TN1_UNS_16H	FALSE
eQTL_Cytoimmgen_TN2_Lowly_Active_STIM_16H	/storage/yangjianLab/guoyazhou/GAMMA_github/gamma-script/scripts/L2G/MAGIC_data/QTL_lite_besd/besd/eQTL_Cytoimmgen_TN2_Lowly_Active_STIM_16H	FALSE
eQTL_Cytoimmgen_TN2_STIM_16H	/storage/yangjianLab/guoyazhou/GAMMA_github/gamma-script/scripts/L2G/MAGIC_data/QTL_lite_besd/besd/eQTL_Cytoimmgen_TN2_STIM_16H	FALSE
eQTL_Cytoimmgen_TN2_STIM_40H	/storage/yangjianLab/guoyazhou/GAMMA_github/gamma-script/scripts/L2G/MAGIC_data/QTL_lite_besd/besd/eQTL_Cytoimmgen_TN2_STIM_40H	FALSE
eQTL_Cytoimmgen_TN2_UNS_16H	/storage/yangjianLab/guoyazhou/GAMMA_github/gamma-script/scripts/L2G/MAGIC_data/QTL_lite_besd/besd/eQTL_Cytoimmgen_TN2_UNS_16H	FALSE
eQTL_Cytoimmgen_TN3_Lowly_Active_STIM_16H	/storage/yangjianLab/guoyazhou/GAMMA_github/gamma-script/scripts/L2G/MAGIC_data/QTL_lite_besd/besd/eQTL_Cytoimmgen_TN3_Lowly_Active_STIM_16H	FALSE
eQTL_Cytoimmgen_TN3_UNS_16H	/storage/yangjianLab/guoyazhou/GAMMA_github/gamma-script/scripts/L2G/MAGIC_data/QTL_lite_besd/besd/eQTL_Cytoimmgen_TN3_UNS_16H	FALSE
eQTL_Cytoimmgen_TN_A_STIM_16H	/storage/yangjianLab/guoyazhou/GAMMA_github/gamma-script/scripts/L2G/MAGIC_data/QTL_lite_besd/besd/eQTL_Cytoimmgen_TN_A_STIM_16H	FALSE
eQTL_Cytoimmgen_TN_A_STIM_40H	/storage/yangjianLab/guoyazhou/GAMMA_github/gamma-script/scripts/L2G/MAGIC_data/QTL_lite_besd/besd/eQTL_Cytoimmgen_TN_A_STIM_40H	FALSE
eQTL_Cytoimmgen_TN_B_STIM_16H	/storage/yangjianLab/guoyazhou/GAMMA_github/gamma-script/scripts/L2G/MAGIC_data/QTL_lite_besd/besd/eQTL_Cytoimmgen_TN_B_STIM_16H	FALSE
eQTL_Cytoimmgen_TN_C_STIM_16H	/storage/yangjianLab/guoyazhou/GAMMA_github/gamma-script/scripts/L2G/MAGIC_data/QTL_lite_besd/besd/eQTL_Cytoimmgen_TN_C_STIM_16H	FALSE
eQTL_Cytoimmgen_TN_cycling_STIM_40H	/storage/yangjianLab/guoyazhou/GAMMA_github/gamma-script/scripts/L2G/MAGIC_data/QTL_lite_besd/besd/eQTL_Cytoimmgen_TN_cycling_STIM_40H	FALSE
eQTL_Cytoimmgen_TN_cycling_STIM_5D	/storage/yangjianLab/guoyazhou/GAMMA_github/gamma-script/scripts/L2G/MAGIC_data/QTL_lite_besd/besd/eQTL_Cytoimmgen_TN_cycling_STIM_5D	FALSE
eQTL_Cytoimmgen_T_NFKB_STIM_16H	/storage/yangjianLab/guoyazhou/GAMMA_github/gamma-script/scripts/L2G/MAGIC_data/QTL_lite_besd/besd/eQTL_Cytoimmgen_T_NFKB_STIM_16H	FALSE
eQTL_Cytoimmgen_TN_HSP_STIM_5D	/storage/yangjianLab/guoyazhou/GAMMA_github/gamma-script/scripts/L2G/MAGIC_data/QTL_lite_besd/besd/eQTL_Cytoimmgen_TN_HSP_STIM_5D	FALSE
eQTL_Cytoimmgen_TN_IFN_Lowly_Active_STIM_16H	/storage/yangjianLab/guoyazhou/GAMMA_github/gamma-script/scripts/L2G/MAGIC_data/QTL_lite_besd/besd/eQTL_Cytoimmgen_TN_IFN_Lowly_Active_STIM_16H	FALSE
eQTL_Cytoimmgen_TN_IFN_Lowly_Active_STIM_40H	/storage/yangjianLab/guoyazhou/GAMMA_github/gamma-script/scripts/L2G/MAGIC_data/QTL_lite_besd/besd/eQTL_Cytoimmgen_TN_IFN_Lowly_Active_STIM_40H	FALSE
eQTL_Cytoimmgen_TN_IFN_STIM_16H	/storage/yangjianLab/guoyazhou/GAMMA_github/gamma-script/scripts/L2G/MAGIC_data/QTL_lite_besd/besd/eQTL_Cytoimmgen_TN_IFN_STIM_16H	FALSE
eQTL_Cytoimmgen_TN_IFN_STIM_40H	/storage/yangjianLab/guoyazhou/GAMMA_github/gamma-script/scripts/L2G/MAGIC_data/QTL_lite_besd/besd/eQTL_Cytoimmgen_TN_IFN_STIM_40H	FALSE
eQTL_Cytoimmgen_TN_IFN_STIM_5D	/storage/yangjianLab/guoyazhou/GAMMA_github/gamma-script/scripts/L2G/MAGIC_data/QTL_lite_besd/besd/eQTL_Cytoimmgen_TN_IFN_STIM_5D	FALSE
eQTL_Cytoimmgen_TN_NFKB_STIM_40H	/storage/yangjianLab/guoyazhou/GAMMA_github/gamma-script/scripts/L2G/MAGIC_data/QTL_lite_besd/besd/eQTL_Cytoimmgen_TN_NFKB_STIM_40H	FALSE
eQTL_Cytoimmgen_TN_NFKB_STIM_5D	/storage/yangjianLab/guoyazhou/GAMMA_github/gamma-script/scripts/L2G/MAGIC_data/QTL_lite_besd/besd/eQTL_Cytoimmgen_TN_NFKB_STIM_5D	FALSE
eQTL_Cytoimmgen_TN_STIM_5D	/storage/yangjianLab/guoyazhou/GAMMA_github/gamma-script/scripts/L2G/MAGIC_data/QTL_lite_besd/besd/eQTL_Cytoimmgen_TN_STIM_5D	FALSE
eQTL_Cytoimmgen_TN-TCM_CXCR4+_STIM_40H	/storage/yangjianLab/guoyazhou/GAMMA_github/gamma-script/scripts/L2G/MAGIC_data/QTL_lite_besd/besd/eQTL_Cytoimmgen_TN-TCM_CXCR4+_STIM_40H	FALSE
eQTL_Astrocytes_Haglund_2025_NG	/storage/yangjianLab/guoyazhou/GAMMA_github/gamma-script/scripts/L2G/MAGIC_data/QTL_lite_besd/besd/eQTL_Astrocytes_Haglund_2025_NG	TRUE
eQTL_Endothelial_cells_Haglund_2025_NG	/storage/yangjianLab/guoyazhou/GAMMA_github/gamma-script/scripts/L2G/MAGIC_data/QTL_lite_besd/besd/eQTL_Endothelial_cells_Haglund_2025_NG	TRUE
eQTL_Excitatory_Neurons_Haglund_2025_NG	/storage/yangjianLab/guoyazhou/GAMMA_github/gamma-script/scripts/L2G/MAGIC_data/QTL_lite_besd/besd/eQTL_Excitatory_Neurons_Haglund_2025_NG	TRUE
eQTL_Inhibitory_Neurons_Haglund_2025_NG	/storage/yangjianLab/guoyazhou/GAMMA_github/gamma-script/scripts/L2G/MAGIC_data/QTL_lite_besd/besd/eQTL_Inhibitory_Neurons_Haglund_2025_NG	TRUE
eQTL_Microglia_Haglund_2025_NG	/storage/yangjianLab/guoyazhou/GAMMA_github/gamma-script/scripts/L2G/MAGIC_data/QTL_lite_besd/besd/eQTL_Microglia_Haglund_2025_NG	TRUE
eQTL_OPCs_Haglund_2025_NG	/storage/yangjianLab/guoyazhou/GAMMA_github/gamma-script/scripts/L2G/MAGIC_data/QTL_lite_besd/besd/eQTL_OPCs_Haglund_2025_NG	TRUE
eQTL_Oligodendrocytes_Haglund_2025_NG	/storage/yangjianLab/guoyazhou/GAMMA_github/gamma-script/scripts/L2G/MAGIC_data/QTL_lite_besd/besd/eQTL_Oligodendrocytes_Haglund_2025_NG	TRUE
eQTL_Pericytes_Haglund_2025_NG	/storage/yangjianLab/guoyazhou/GAMMA_github/gamma-script/scripts/L2G/MAGIC_data/QTL_lite_besd/besd/eQTL_Pericytes_Haglund_2025_NG	TRUE
eQTL_Brain_Astrocytes	/storage/yangjianLab/guoyazhou/GAMMA_github/gamma-script/scripts/L2G/MAGIC_data/QTL_lite_besd/besd/eQTL_Brain_Astrocytes	FALSE
eQTL_Brain_Endothelial.cells	/storage/yangjianLab/guoyazhou/GAMMA_github/gamma-script/scripts/L2G/MAGIC_data/QTL_lite_besd/besd/eQTL_Brain_Endothelial.cells	FALSE
eQTL_Brain_Excitatory.neurons	/storage/yangjianLab/guoyazhou/GAMMA_github/gamma-script/scripts/L2G/MAGIC_data/QTL_lite_besd/besd/eQTL_Brain_Excitatory.neurons	FALSE
eQTL_Brain_Inhibitory.neurons	/storage/yangjianLab/guoyazhou/GAMMA_github/gamma-script/scripts/L2G/MAGIC_data/QTL_lite_besd/besd/eQTL_Brain_Inhibitory.neurons	FALSE
eQTL_Brain_Microglia	/storage/yangjianLab/guoyazhou/GAMMA_github/gamma-script/scripts/L2G/MAGIC_data/QTL_lite_besd/besd/eQTL_Brain_Microglia	FALSE
eQTL_Brain_Oligodendrocytes	/storage/yangjianLab/guoyazhou/GAMMA_github/gamma-script/scripts/L2G/MAGIC_data/QTL_lite_besd/besd/eQTL_Brain_Oligodendrocytes	FALSE
eQTL_Brain_OPCs...COPs	/storage/yangjianLab/guoyazhou/GAMMA_github/gamma-script/scripts/L2G/MAGIC_data/QTL_lite_besd/besd/eQTL_Brain_OPCs...COPs	FALSE
eQTL_Brain_Pericytes	/storage/yangjianLab/guoyazhou/GAMMA_github/gamma-script/scripts/L2G/MAGIC_data/QTL_lite_besd/besd/eQTL_Brain_Pericytes	FALSE
eQTL_OneK1K_bin	/storage/yangjianLab/guoyazhou/GAMMA_github/gamma-script/scripts/L2G/MAGIC_data/QTL_lite_besd/besd/eQTL_OneK1K_bin	FALSE
eQTL_OneK1K_bmem	/storage/yangjianLab/guoyazhou/GAMMA_github/gamma-script/scripts/L2G/MAGIC_data/QTL_lite_besd/besd/eQTL_OneK1K_bmem	FALSE
eQTL_OneK1K_cd4et	/storage/yangjianLab/guoyazhou/GAMMA_github/gamma-script/scripts/L2G/MAGIC_data/QTL_lite_besd/besd/eQTL_OneK1K_cd4et	FALSE
eQTL_OneK1K_cd4nc	/storage/yangjianLab/guoyazhou/GAMMA_github/gamma-script/scripts/L2G/MAGIC_data/QTL_lite_besd/besd/eQTL_OneK1K_cd4nc	FALSE
eQTL_OneK1K_cd4sox4	/storage/yangjianLab/guoyazhou/GAMMA_github/gamma-script/scripts/L2G/MAGIC_data/QTL_lite_besd/besd/eQTL_OneK1K_cd4sox4	FALSE
eQTL_OneK1K_cd8et	/storage/yangjianLab/guoyazhou/GAMMA_github/gamma-script/scripts/L2G/MAGIC_data/QTL_lite_besd/besd/eQTL_OneK1K_cd8et	FALSE
eQTL_OneK1K_cd8nc	/storage/yangjianLab/guoyazhou/GAMMA_github/gamma-script/scripts/L2G/MAGIC_data/QTL_lite_besd/besd/eQTL_OneK1K_cd8nc	FALSE
eQTL_OneK1K_cd8s100b	/storage/yangjianLab/guoyazhou/GAMMA_github/gamma-script/scripts/L2G/MAGIC_data/QTL_lite_besd/besd/eQTL_OneK1K_cd8s100b	FALSE
eQTL_OneK1K_dc	/storage/yangjianLab/guoyazhou/GAMMA_github/gamma-script/scripts/L2G/MAGIC_data/QTL_lite_besd/besd/eQTL_OneK1K_dc	FALSE
eQTL_OneK1K_monoc	/storage/yangjianLab/guoyazhou/GAMMA_github/gamma-script/scripts/L2G/MAGIC_data/QTL_lite_besd/besd/eQTL_OneK1K_monoc	FALSE
eQTL_OneK1K_mononc	/storage/yangjianLab/guoyazhou/GAMMA_github/gamma-script/scripts/L2G/MAGIC_data/QTL_lite_besd/besd/eQTL_OneK1K_mononc	FALSE
eQTL_OneK1K_nkr	/storage/yangjianLab/guoyazhou/GAMMA_github/gamma-script/scripts/L2G/MAGIC_data/QTL_lite_besd/besd/eQTL_OneK1K_nkr	FALSE
eQTL_OneK1K_nk	/storage/yangjianLab/guoyazhou/GAMMA_github/gamma-script/scripts/L2G/MAGIC_data/QTL_lite_besd/besd/eQTL_OneK1K_nk	FALSE
eQTL_OneK1K_plasma	/storage/yangjianLab/guoyazhou/GAMMA_github/gamma-script/scripts/L2G/MAGIC_data/QTL_lite_besd/besd/eQTL_OneK1K_plasma	FALSE
eQTL_GTEx_Adipose_Subcutaneous	/storage/yangjianLab/guoyazhou/GAMMA_github/gamma-script/scripts/L2G/MAGIC_data/QTL_lite_besd/besd/eQTL_GTEx_Adipose_Subcutaneous	TRUE
eQTL_GTEx_Adipose_Visceral_Omentum	/storage/yangjianLab/guoyazhou/GAMMA_github/gamma-script/scripts/L2G/MAGIC_data/QTL_lite_besd/besd/eQTL_GTEx_Adipose_Visceral_Omentum	TRUE
eQTL_GTEx_Adrenal_Gland	/storage/yangjianLab/guoyazhou/GAMMA_github/gamma-script/scripts/L2G/MAGIC_data/QTL_lite_besd/besd/eQTL_GTEx_Adrenal_Gland	TRUE
eQTL_GTEx_Artery_Aorta	/storage/yangjianLab/guoyazhou/GAMMA_github/gamma-script/scripts/L2G/MAGIC_data/QTL_lite_besd/besd/eQTL_GTEx_Artery_Aorta	TRUE
eQTL_GTEx_Artery_Coronary	/storage/yangjianLab/guoyazhou/GAMMA_github/gamma-script/scripts/L2G/MAGIC_data/QTL_lite_besd/besd/eQTL_GTEx_Artery_Coronary	TRUE
eQTL_GTEx_Artery_Tibial	/storage/yangjianLab/guoyazhou/GAMMA_github/gamma-script/scripts/L2G/MAGIC_data/QTL_lite_besd/besd/eQTL_GTEx_Artery_Tibial	TRUE
eQTL_GTEx_Brain_Amygdala	/storage/yangjianLab/guoyazhou/GAMMA_github/gamma-script/scripts/L2G/MAGIC_data/QTL_lite_besd/besd/eQTL_GTEx_Brain_Amygdala	TRUE
eQTL_GTEx_Brain_Anterior_cingulate_cortex_BA24	/storage/yangjianLab/guoyazhou/GAMMA_github/gamma-script/scripts/L2G/MAGIC_data/QTL_lite_besd/besd/eQTL_GTEx_Brain_Anterior_cingulate_cortex_BA24	TRUE
eQTL_GTEx_Brain_Caudate_basal_ganglia	/storage/yangjianLab/guoyazhou/GAMMA_github/gamma-script/scripts/L2G/MAGIC_data/QTL_lite_besd/besd/eQTL_GTEx_Brain_Caudate_basal_ganglia	TRUE
eQTL_GTEx_Brain_Cerebellar_Hemisphere	/storage/yangjianLab/guoyazhou/GAMMA_github/gamma-script/scripts/L2G/MAGIC_data/QTL_lite_besd/besd/eQTL_GTEx_Brain_Cerebellar_Hemisphere	TRUE
eQTL_GTEx_Brain_Cerebellum	/storage/yangjianLab/guoyazhou/GAMMA_github/gamma-script/scripts/L2G/MAGIC_data/QTL_lite_besd/besd/eQTL_GTEx_Brain_Cerebellum	TRUE
eQTL_GTEx_Brain_Cortex	/storage/yangjianLab/guoyazhou/GAMMA_github/gamma-script/scripts/L2G/MAGIC_data/QTL_lite_besd/besd/eQTL_GTEx_Brain_Cortex	TRUE
eQTL_GTEx_Brain_Frontal_Cortex_BA9	/storage/yangjianLab/guoyazhou/GAMMA_github/gamma-script/scripts/L2G/MAGIC_data/QTL_lite_besd/besd/eQTL_GTEx_Brain_Frontal_Cortex_BA9	TRUE
eQTL_GTEx_Brain_Hippocampus	/storage/yangjianLab/guoyazhou/GAMMA_github/gamma-script/scripts/L2G/MAGIC_data/QTL_lite_besd/besd/eQTL_GTEx_Brain_Hippocampus	TRUE
eQTL_GTEx_Brain_Hypothalamus	/storage/yangjianLab/guoyazhou/GAMMA_github/gamma-script/scripts/L2G/MAGIC_data/QTL_lite_besd/besd/eQTL_GTEx_Brain_Hypothalamus	TRUE
eQTL_GTEx_Brain_Nucleus_accumbens_basal_ganglia	/storage/yangjianLab/guoyazhou/GAMMA_github/gamma-script/scripts/L2G/MAGIC_data/QTL_lite_besd/besd/eQTL_GTEx_Brain_Nucleus_accumbens_basal_ganglia	TRUE
eQTL_GTEx_Brain_Putamen_basal_ganglia	/storage/yangjianLab/guoyazhou/GAMMA_github/gamma-script/scripts/L2G/MAGIC_data/QTL_lite_besd/besd/eQTL_GTEx_Brain_Putamen_basal_ganglia	TRUE
eQTL_GTEx_Brain_Spinal_cord_cervical_c-1	/storage/yangjianLab/guoyazhou/GAMMA_github/gamma-script/scripts/L2G/MAGIC_data/QTL_lite_besd/besd/eQTL_GTEx_Brain_Spinal_cord_cervical_c-1	TRUE
eQTL_GTEx_Brain_Substantia_nigra	/storage/yangjianLab/guoyazhou/GAMMA_github/gamma-script/scripts/L2G/MAGIC_data/QTL_lite_besd/besd/eQTL_GTEx_Brain_Substantia_nigra	TRUE
eQTL_GTEx_Breast_Mammary_Tissue	/storage/yangjianLab/guoyazhou/GAMMA_github/gamma-script/scripts/L2G/MAGIC_data/QTL_lite_besd/besd/eQTL_GTEx_Breast_Mammary_Tissue	TRUE
eQTL_GTEx_Cells_Cultured_fibroblasts	/storage/yangjianLab/guoyazhou/GAMMA_github/gamma-script/scripts/L2G/MAGIC_data/QTL_lite_besd/besd/eQTL_GTEx_Cells_Cultured_fibroblasts	TRUE
eQTL_GTEx_Cells_EBV-transformed_lymphocytes	/storage/yangjianLab/guoyazhou/GAMMA_github/gamma-script/scripts/L2G/MAGIC_data/QTL_lite_besd/besd/eQTL_GTEx_Cells_EBV-transformed_lymphocytes	TRUE
eQTL_GTEx_Colon_Sigmoid	/storage/yangjianLab/guoyazhou/GAMMA_github/gamma-script/scripts/L2G/MAGIC_data/QTL_lite_besd/besd/eQTL_GTEx_Colon_Sigmoid	TRUE
eQTL_GTEx_Colon_Transverse	/storage/yangjianLab/guoyazhou/GAMMA_github/gamma-script/scripts/L2G/MAGIC_data/QTL_lite_besd/besd/eQTL_GTEx_Colon_Transverse	TRUE
eQTL_GTEx_Esophagus_Gastroesophageal_Junction	/storage/yangjianLab/guoyazhou/GAMMA_github/gamma-script/scripts/L2G/MAGIC_data/QTL_lite_besd/besd/eQTL_GTEx_Esophagus_Gastroesophageal_Junction	TRUE
eQTL_GTEx_Esophagus_Mucosa	/storage/yangjianLab/guoyazhou/GAMMA_github/gamma-script/scripts/L2G/MAGIC_data/QTL_lite_besd/besd/eQTL_GTEx_Esophagus_Mucosa	TRUE
eQTL_GTEx_Esophagus_Muscularis	/storage/yangjianLab/guoyazhou/GAMMA_github/gamma-script/scripts/L2G/MAGIC_data/QTL_lite_besd/besd/eQTL_GTEx_Esophagus_Muscularis	TRUE
eQTL_GTEx_Heart_Atrial_Appendage	/storage/yangjianLab/guoyazhou/GAMMA_github/gamma-script/scripts/L2G/MAGIC_data/QTL_lite_besd/besd/eQTL_GTEx_Heart_Atrial_Appendage	TRUE
eQTL_GTEx_Heart_Left_Ventricle	/storage/yangjianLab/guoyazhou/GAMMA_github/gamma-script/scripts/L2G/MAGIC_data/QTL_lite_besd/besd/eQTL_GTEx_Heart_Left_Ventricle	TRUE
eQTL_GTEx_Kidney_Cortex	/storage/yangjianLab/guoyazhou/GAMMA_github/gamma-script/scripts/L2G/MAGIC_data/QTL_lite_besd/besd/eQTL_GTEx_Kidney_Cortex	TRUE
eQTL_GTEx_Liver	/storage/yangjianLab/guoyazhou/GAMMA_github/gamma-script/scripts/L2G/MAGIC_data/QTL_lite_besd/besd/eQTL_GTEx_Liver	TRUE
eQTL_GTEx_Lung	/storage/yangjianLab/guoyazhou/GAMMA_github/gamma-script/scripts/L2G/MAGIC_data/QTL_lite_besd/besd/eQTL_GTEx_Lung	TRUE
eQTL_GTEx_Minor_Salivary_Gland	/storage/yangjianLab/guoyazhou/GAMMA_github/gamma-script/scripts/L2G/MAGIC_data/QTL_lite_besd/besd/eQTL_GTEx_Minor_Salivary_Gland	TRUE
eQTL_GTEx_Muscle_Skeletal	/storage/yangjianLab/guoyazhou/GAMMA_github/gamma-script/scripts/L2G/MAGIC_data/QTL_lite_besd/besd/eQTL_GTEx_Muscle_Skeletal	TRUE
eQTL_GTEx_Nerve_Tibial	/storage/yangjianLab/guoyazhou/GAMMA_github/gamma-script/scripts/L2G/MAGIC_data/QTL_lite_besd/besd/eQTL_GTEx_Nerve_Tibial	TRUE
eQTL_GTEx_Ovary	/storage/yangjianLab/guoyazhou/GAMMA_github/gamma-script/scripts/L2G/MAGIC_data/QTL_lite_besd/besd/eQTL_GTEx_Ovary	TRUE
eQTL_GTEx_Pancreas	/storage/yangjianLab/guoyazhou/GAMMA_github/gamma-script/scripts/L2G/MAGIC_data/QTL_lite_besd/besd/eQTL_GTEx_Pancreas	TRUE
eQTL_GTEx_Pituitary	/storage/yangjianLab/guoyazhou/GAMMA_github/gamma-script/scripts/L2G/MAGIC_data/QTL_lite_besd/besd/eQTL_GTEx_Pituitary	TRUE
eQTL_GTEx_Prostate	/storage/yangjianLab/guoyazhou/GAMMA_github/gamma-script/scripts/L2G/MAGIC_data/QTL_lite_besd/besd/eQTL_GTEx_Prostate	TRUE
eQTL_GTEx_Skin_Not_Sun_Exposed_Suprapubic	/storage/yangjianLab/guoyazhou/GAMMA_github/gamma-script/scripts/L2G/MAGIC_data/QTL_lite_besd/besd/eQTL_GTEx_Skin_Not_Sun_Exposed_Suprapubic	TRUE
eQTL_GTEx_Skin_Sun_Exposed_Lower_leg	/storage/yangjianLab/guoyazhou/GAMMA_github/gamma-script/scripts/L2G/MAGIC_data/QTL_lite_besd/besd/eQTL_GTEx_Skin_Sun_Exposed_Lower_leg	TRUE
eQTL_GTEx_Small_Intestine_Terminal_Ileum	/storage/yangjianLab/guoyazhou/GAMMA_github/gamma-script/scripts/L2G/MAGIC_data/QTL_lite_besd/besd/eQTL_GTEx_Small_Intestine_Terminal_Ileum	TRUE
eQTL_GTEx_Spleen	/storage/yangjianLab/guoyazhou/GAMMA_github/gamma-script/scripts/L2G/MAGIC_data/QTL_lite_besd/besd/eQTL_GTEx_Spleen	TRUE
eQTL_GTEx_Stomach	/storage/yangjianLab/guoyazhou/GAMMA_github/gamma-script/scripts/L2G/MAGIC_data/QTL_lite_besd/besd/eQTL_GTEx_Stomach	TRUE
eQTL_GTEx_Testis	/storage/yangjianLab/guoyazhou/GAMMA_github/gamma-script/scripts/L2G/MAGIC_data/QTL_lite_besd/besd/eQTL_GTEx_Testis	TRUE
eQTL_GTEx_Thyroid	/storage/yangjianLab/guoyazhou/GAMMA_github/gamma-script/scripts/L2G/MAGIC_data/QTL_lite_besd/besd/eQTL_GTEx_Thyroid	TRUE
eQTL_GTEx_Uterus	/storage/yangjianLab/guoyazhou/GAMMA_github/gamma-script/scripts/L2G/MAGIC_data/QTL_lite_besd/besd/eQTL_GTEx_Uterus	TRUE
eQTL_GTEx_Vagina	/storage/yangjianLab/guoyazhou/GAMMA_github/gamma-script/scripts/L2G/MAGIC_data/QTL_lite_besd/besd/eQTL_GTEx_Vagina	TRUE
eQTL_GTEx_Whole_Blood	/storage/yangjianLab/guoyazhou/GAMMA_github/gamma-script/scripts/L2G/MAGIC_data/QTL_lite_besd/besd/eQTL_GTEx_Whole_Blood	TRUE
eQTL_ROSMAP_snRNA_celltype_Ast	/storage/yangjianLab/guoyazhou/GAMMA_github/gamma-script/scripts/L2G/MAGIC_data/QTL_lite_besd/besd/eQTL_ROSMAP_snRNA_celltype_Ast	FALSE
eQTL_ROSMAP_snRNA_celltype_End	/storage/yangjianLab/guoyazhou/GAMMA_github/gamma-script/scripts/L2G/MAGIC_data/QTL_lite_besd/besd/eQTL_ROSMAP_snRNA_celltype_End	FALSE
eQTL_ROSMAP_snRNA_celltype_Exc	/storage/yangjianLab/guoyazhou/GAMMA_github/gamma-script/scripts/L2G/MAGIC_data/QTL_lite_besd/besd/eQTL_ROSMAP_snRNA_celltype_Exc	FALSE
eQTL_ROSMAP_snRNA_celltype_Inh	/storage/yangjianLab/guoyazhou/GAMMA_github/gamma-script/scripts/L2G/MAGIC_data/QTL_lite_besd/besd/eQTL_ROSMAP_snRNA_celltype_Inh	FALSE
eQTL_ROSMAP_snRNA_celltype_Mic	/storage/yangjianLab/guoyazhou/GAMMA_github/gamma-script/scripts/L2G/MAGIC_data/QTL_lite_besd/besd/eQTL_ROSMAP_snRNA_celltype_Mic	FALSE
eQTL_ROSMAP_snRNA_celltype_Oli	/storage/yangjianLab/guoyazhou/GAMMA_github/gamma-script/scripts/L2G/MAGIC_data/QTL_lite_besd/besd/eQTL_ROSMAP_snRNA_celltype_Oli	FALSE
eQTL_ROSMAP_snRNA_celltype_OPC	/storage/yangjianLab/guoyazhou/GAMMA_github/gamma-script/scripts/L2G/MAGIC_data/QTL_lite_besd/besd/eQTL_ROSMAP_snRNA_celltype_OPC	FALSE
eQTL_ROSMAP_snRNA_subtype_Ast.10	/storage/yangjianLab/guoyazhou/GAMMA_github/gamma-script/scripts/L2G/MAGIC_data/QTL_lite_besd/besd/eQTL_ROSMAP_snRNA_subtype_Ast.10	FALSE
eQTL_ROSMAP_snRNA_subtype_Ast.1	/storage/yangjianLab/guoyazhou/GAMMA_github/gamma-script/scripts/L2G/MAGIC_data/QTL_lite_besd/besd/eQTL_ROSMAP_snRNA_subtype_Ast.1	FALSE
eQTL_ROSMAP_snRNA_subtype_Ast.2	/storage/yangjianLab/guoyazhou/GAMMA_github/gamma-script/scripts/L2G/MAGIC_data/QTL_lite_besd/besd/eQTL_ROSMAP_snRNA_subtype_Ast.2	FALSE
eQTL_ROSMAP_snRNA_subtype_Ast.3	/storage/yangjianLab/guoyazhou/GAMMA_github/gamma-script/scripts/L2G/MAGIC_data/QTL_lite_besd/besd/eQTL_ROSMAP_snRNA_subtype_Ast.3	FALSE
eQTL_ROSMAP_snRNA_subtype_Ast.4	/storage/yangjianLab/guoyazhou/GAMMA_github/gamma-script/scripts/L2G/MAGIC_data/QTL_lite_besd/besd/eQTL_ROSMAP_snRNA_subtype_Ast.4	FALSE
eQTL_ROSMAP_snRNA_subtype_Ast.5	/storage/yangjianLab/guoyazhou/GAMMA_github/gamma-script/scripts/L2G/MAGIC_data/QTL_lite_besd/besd/eQTL_ROSMAP_snRNA_subtype_Ast.5	FALSE
eQTL_ROSMAP_snRNA_subtype_Ast.6	/storage/yangjianLab/guoyazhou/GAMMA_github/gamma-script/scripts/L2G/MAGIC_data/QTL_lite_besd/besd/eQTL_ROSMAP_snRNA_subtype_Ast.6	FALSE
eQTL_ROSMAP_snRNA_subtype_Exc.10	/storage/yangjianLab/guoyazhou/GAMMA_github/gamma-script/scripts/L2G/MAGIC_data/QTL_lite_besd/besd/eQTL_ROSMAP_snRNA_subtype_Exc.10	FALSE
eQTL_ROSMAP_snRNA_subtype_Exc.11	/storage/yangjianLab/guoyazhou/GAMMA_github/gamma-script/scripts/L2G/MAGIC_data/QTL_lite_besd/besd/eQTL_ROSMAP_snRNA_subtype_Exc.11	FALSE
eQTL_ROSMAP_snRNA_subtype_Exc.12	/storage/yangjianLab/guoyazhou/GAMMA_github/gamma-script/scripts/L2G/MAGIC_data/QTL_lite_besd/besd/eQTL_ROSMAP_snRNA_subtype_Exc.12	FALSE
eQTL_ROSMAP_snRNA_subtype_Exc.13	/storage/yangjianLab/guoyazhou/GAMMA_github/gamma-script/scripts/L2G/MAGIC_data/QTL_lite_besd/besd/eQTL_ROSMAP_snRNA_subtype_Exc.13	FALSE
eQTL_ROSMAP_snRNA_subtype_Exc.14	/storage/yangjianLab/guoyazhou/GAMMA_github/gamma-script/scripts/L2G/MAGIC_data/QTL_lite_besd/besd/eQTL_ROSMAP_snRNA_subtype_Exc.14	FALSE
eQTL_ROSMAP_snRNA_subtype_Exc.15	/storage/yangjianLab/guoyazhou/GAMMA_github/gamma-script/scripts/L2G/MAGIC_data/QTL_lite_besd/besd/eQTL_ROSMAP_snRNA_subtype_Exc.15	FALSE
eQTL_ROSMAP_snRNA_subtype_Exc.16	/storage/yangjianLab/guoyazhou/GAMMA_github/gamma-script/scripts/L2G/MAGIC_data/QTL_lite_besd/besd/eQTL_ROSMAP_snRNA_subtype_Exc.16	FALSE
eQTL_ROSMAP_snRNA_subtype_Exc.2	/storage/yangjianLab/guoyazhou/GAMMA_github/gamma-script/scripts/L2G/MAGIC_data/QTL_lite_besd/besd/eQTL_ROSMAP_snRNA_subtype_Exc.2	FALSE
eQTL_ROSMAP_snRNA_subtype_Exc.3	/storage/yangjianLab/guoyazhou/GAMMA_github/gamma-script/scripts/L2G/MAGIC_data/QTL_lite_besd/besd/eQTL_ROSMAP_snRNA_subtype_Exc.3	FALSE
eQTL_ROSMAP_snRNA_subtype_Exc.4	/storage/yangjianLab/guoyazhou/GAMMA_github/gamma-script/scripts/L2G/MAGIC_data/QTL_lite_besd/besd/eQTL_ROSMAP_snRNA_subtype_Exc.4	FALSE
eQTL_ROSMAP_snRNA_subtype_Exc.5	/storage/yangjianLab/guoyazhou/GAMMA_github/gamma-script/scripts/L2G/MAGIC_data/QTL_lite_besd/besd/eQTL_ROSMAP_snRNA_subtype_Exc.5	FALSE
eQTL_ROSMAP_snRNA_subtype_Exc.6	/storage/yangjianLab/guoyazhou/GAMMA_github/gamma-script/scripts/L2G/MAGIC_data/QTL_lite_besd/besd/eQTL_ROSMAP_snRNA_subtype_Exc.6	FALSE
eQTL_ROSMAP_snRNA_subtype_Exc.7	/storage/yangjianLab/guoyazhou/GAMMA_github/gamma-script/scripts/L2G/MAGIC_data/QTL_lite_besd/besd/eQTL_ROSMAP_snRNA_subtype_Exc.7	FALSE
eQTL_ROSMAP_snRNA_subtype_Exc.8	/storage/yangjianLab/guoyazhou/GAMMA_github/gamma-script/scripts/L2G/MAGIC_data/QTL_lite_besd/besd/eQTL_ROSMAP_snRNA_subtype_Exc.8	FALSE
eQTL_ROSMAP_snRNA_subtype_Exc.9	/storage/yangjianLab/guoyazhou/GAMMA_github/gamma-script/scripts/L2G/MAGIC_data/QTL_lite_besd/besd/eQTL_ROSMAP_snRNA_subtype_Exc.9	FALSE
eQTL_ROSMAP_snRNA_subtype_Fib.3	/storage/yangjianLab/guoyazhou/GAMMA_github/gamma-script/scripts/L2G/MAGIC_data/QTL_lite_besd/besd/eQTL_ROSMAP_snRNA_subtype_Fib.3	FALSE
eQTL_ROSMAP_snRNA_subtype_Inh.10	/storage/yangjianLab/guoyazhou/GAMMA_github/gamma-script/scripts/L2G/MAGIC_data/QTL_lite_besd/besd/eQTL_ROSMAP_snRNA_subtype_Inh.10	FALSE
eQTL_ROSMAP_snRNA_subtype_Inh.11	/storage/yangjianLab/guoyazhou/GAMMA_github/gamma-script/scripts/L2G/MAGIC_data/QTL_lite_besd/besd/eQTL_ROSMAP_snRNA_subtype_Inh.11	FALSE
eQTL_ROSMAP_snRNA_subtype_Inh.12	/storage/yangjianLab/guoyazhou/GAMMA_github/gamma-script/scripts/L2G/MAGIC_data/QTL_lite_besd/besd/eQTL_ROSMAP_snRNA_subtype_Inh.12	FALSE
eQTL_ROSMAP_snRNA_subtype_Inh.13	/storage/yangjianLab/guoyazhou/GAMMA_github/gamma-script/scripts/L2G/MAGIC_data/QTL_lite_besd/besd/eQTL_ROSMAP_snRNA_subtype_Inh.13	FALSE
eQTL_ROSMAP_snRNA_subtype_Inh.15	/storage/yangjianLab/guoyazhou/GAMMA_github/gamma-script/scripts/L2G/MAGIC_data/QTL_lite_besd/besd/eQTL_ROSMAP_snRNA_subtype_Inh.15	FALSE
eQTL_ROSMAP_snRNA_subtype_Inh.16	/storage/yangjianLab/guoyazhou/GAMMA_github/gamma-script/scripts/L2G/MAGIC_data/QTL_lite_besd/besd/eQTL_ROSMAP_snRNA_subtype_Inh.16	FALSE
eQTL_ROSMAP_snRNA_subtype_Inh.2	/storage/yangjianLab/guoyazhou/GAMMA_github/gamma-script/scripts/L2G/MAGIC_data/QTL_lite_besd/besd/eQTL_ROSMAP_snRNA_subtype_Inh.2	FALSE
eQTL_ROSMAP_snRNA_subtype_Inh.3	/storage/yangjianLab/guoyazhou/GAMMA_github/gamma-script/scripts/L2G/MAGIC_data/QTL_lite_besd/besd/eQTL_ROSMAP_snRNA_subtype_Inh.3	FALSE
eQTL_ROSMAP_snRNA_subtype_Inh.4	/storage/yangjianLab/guoyazhou/GAMMA_github/gamma-script/scripts/L2G/MAGIC_data/QTL_lite_besd/besd/eQTL_ROSMAP_snRNA_subtype_Inh.4	FALSE
eQTL_ROSMAP_snRNA_subtype_Inh.5	/storage/yangjianLab/guoyazhou/GAMMA_github/gamma-script/scripts/L2G/MAGIC_data/QTL_lite_besd/besd/eQTL_ROSMAP_snRNA_subtype_Inh.5	FALSE
eQTL_ROSMAP_snRNA_subtype_Inh.6	/storage/yangjianLab/guoyazhou/GAMMA_github/gamma-script/scripts/L2G/MAGIC_data/QTL_lite_besd/besd/eQTL_ROSMAP_snRNA_subtype_Inh.6	FALSE
eQTL_ROSMAP_snRNA_subtype_Inh.7	/storage/yangjianLab/guoyazhou/GAMMA_github/gamma-script/scripts/L2G/MAGIC_data/QTL_lite_besd/besd/eQTL_ROSMAP_snRNA_subtype_Inh.7	FALSE
eQTL_ROSMAP_snRNA_subtype_Inh.8	/storage/yangjianLab/guoyazhou/GAMMA_github/gamma-script/scripts/L2G/MAGIC_data/QTL_lite_besd/besd/eQTL_ROSMAP_snRNA_subtype_Inh.8	FALSE
eQTL_ROSMAP_snRNA_subtype_Inh.9	/storage/yangjianLab/guoyazhou/GAMMA_github/gamma-script/scripts/L2G/MAGIC_data/QTL_lite_besd/besd/eQTL_ROSMAP_snRNA_subtype_Inh.9	FALSE
eQTL_ROSMAP_snRNA_subtype_Mic.10	/storage/yangjianLab/guoyazhou/GAMMA_github/gamma-script/scripts/L2G/MAGIC_data/QTL_lite_besd/besd/eQTL_ROSMAP_snRNA_subtype_Mic.10	FALSE
eQTL_ROSMAP_snRNA_subtype_Mic.12	/storage/yangjianLab/guoyazhou/GAMMA_github/gamma-script/scripts/L2G/MAGIC_data/QTL_lite_besd/besd/eQTL_ROSMAP_snRNA_subtype_Mic.12	FALSE
eQTL_ROSMAP_snRNA_subtype_Mic.2	/storage/yangjianLab/guoyazhou/GAMMA_github/gamma-script/scripts/L2G/MAGIC_data/QTL_lite_besd/besd/eQTL_ROSMAP_snRNA_subtype_Mic.2	FALSE
eQTL_ROSMAP_snRNA_subtype_Mic.3	/storage/yangjianLab/guoyazhou/GAMMA_github/gamma-script/scripts/L2G/MAGIC_data/QTL_lite_besd/besd/eQTL_ROSMAP_snRNA_subtype_Mic.3	FALSE
eQTL_ROSMAP_snRNA_subtype_Mic.4	/storage/yangjianLab/guoyazhou/GAMMA_github/gamma-script/scripts/L2G/MAGIC_data/QTL_lite_besd/besd/eQTL_ROSMAP_snRNA_subtype_Mic.4	FALSE
eQTL_ROSMAP_snRNA_subtype_Mic.5	/storage/yangjianLab/guoyazhou/GAMMA_github/gamma-script/scripts/L2G/MAGIC_data/QTL_lite_besd/besd/eQTL_ROSMAP_snRNA_subtype_Mic.5	FALSE
eQTL_ROSMAP_snRNA_subtype_Mic.6	/storage/yangjianLab/guoyazhou/GAMMA_github/gamma-script/scripts/L2G/MAGIC_data/QTL_lite_besd/besd/eQTL_ROSMAP_snRNA_subtype_Mic.6	FALSE
eQTL_ROSMAP_snRNA_subtype_Mic.7	/storage/yangjianLab/guoyazhou/GAMMA_github/gamma-script/scripts/L2G/MAGIC_data/QTL_lite_besd/besd/eQTL_ROSMAP_snRNA_subtype_Mic.7	FALSE
eQTL_ROSMAP_snRNA_subtype_Mic.8	/storage/yangjianLab/guoyazhou/GAMMA_github/gamma-script/scripts/L2G/MAGIC_data/QTL_lite_besd/besd/eQTL_ROSMAP_snRNA_subtype_Mic.8	FALSE
eQTL_ROSMAP_snRNA_subtype_Mic.9	/storage/yangjianLab/guoyazhou/GAMMA_github/gamma-script/scripts/L2G/MAGIC_data/QTL_lite_besd/besd/eQTL_ROSMAP_snRNA_subtype_Mic.9	FALSE
eQTL_ROSMAP_snRNA_subtype_Oli.1	/storage/yangjianLab/guoyazhou/GAMMA_github/gamma-script/scripts/L2G/MAGIC_data/QTL_lite_besd/besd/eQTL_ROSMAP_snRNA_subtype_Oli.1	FALSE
eQTL_ROSMAP_snRNA_subtype_Oli.2	/storage/yangjianLab/guoyazhou/GAMMA_github/gamma-script/scripts/L2G/MAGIC_data/QTL_lite_besd/besd/eQTL_ROSMAP_snRNA_subtype_Oli.2	FALSE
eQTL_ROSMAP_snRNA_subtype_Oli.3	/storage/yangjianLab/guoyazhou/GAMMA_github/gamma-script/scripts/L2G/MAGIC_data/QTL_lite_besd/besd/eQTL_ROSMAP_snRNA_subtype_Oli.3	FALSE
eQTL_ROSMAP_snRNA_subtype_Oli.4	/storage/yangjianLab/guoyazhou/GAMMA_github/gamma-script/scripts/L2G/MAGIC_data/QTL_lite_besd/besd/eQTL_ROSMAP_snRNA_subtype_Oli.4	FALSE
eQTL_ROSMAP_snRNA_subtype_Oli.5	/storage/yangjianLab/guoyazhou/GAMMA_github/gamma-script/scripts/L2G/MAGIC_data/QTL_lite_besd/besd/eQTL_ROSMAP_snRNA_subtype_Oli.5	FALSE
eQTL_ROSMAP_snRNA_subtype_Oli.6	/storage/yangjianLab/guoyazhou/GAMMA_github/gamma-script/scripts/L2G/MAGIC_data/QTL_lite_besd/besd/eQTL_ROSMAP_snRNA_subtype_Oli.6	FALSE
eQTL_ROSMAP_snRNA_subtype_Oli.7	/storage/yangjianLab/guoyazhou/GAMMA_github/gamma-script/scripts/L2G/MAGIC_data/QTL_lite_besd/besd/eQTL_ROSMAP_snRNA_subtype_Oli.7	FALSE
eQTL_ROSMAP_snRNA_subtype_Oli.9	/storage/yangjianLab/guoyazhou/GAMMA_github/gamma-script/scripts/L2G/MAGIC_data/QTL_lite_besd/besd/eQTL_ROSMAP_snRNA_subtype_Oli.9	FALSE
eQTL_ROSMAP_snRNA_subtype_OPC.1	/storage/yangjianLab/guoyazhou/GAMMA_github/gamma-script/scripts/L2G/MAGIC_data/QTL_lite_besd/besd/eQTL_ROSMAP_snRNA_subtype_OPC.1	FALSE
eQTL_ROSMAP_snRNA_subtype_OPC.2	/storage/yangjianLab/guoyazhou/GAMMA_github/gamma-script/scripts/L2G/MAGIC_data/QTL_lite_besd/besd/eQTL_ROSMAP_snRNA_subtype_OPC.2	FALSE
eQTL_ROSMAP_snRNA_subtype_OPC.3	/storage/yangjianLab/guoyazhou/GAMMA_github/gamma-script/scripts/L2G/MAGIC_data/QTL_lite_besd/besd/eQTL_ROSMAP_snRNA_subtype_OPC.3	FALSE



eQTL_ROSMAP_snRNA_subtype_Exc.1	/storage/yangjianLab/guoyazhou/GAMMA_github/gamma-script/scripts/L2G/MAGIC_data/QTL_lite_besd/besd/eQTL_ROSMAP_snRNA_subtype_Exc.1	FALSE
eQTL_ROSMAP_snRNA_subtype_End.2	/storage/yangjianLab/guoyazhou/GAMMA_github/gamma-script/scripts/L2G/MAGIC_data/QTL_lite_besd/besd/eQTL_ROSMAP_snRNA_subtype_End.2	FALSE
eQTL_ROSMAP_snRNA_subtype_Mic.13	/storage/yangjianLab/guoyazhou/GAMMA_github/gamma-script/scripts/L2G/MAGIC_data/QTL_lite_besd/besd/eQTL_ROSMAP_snRNA_subtype_Mic.13	FALSE
eQTL_ROSMAP_snRNA_subtype_Oli.11	/storage/yangjianLab/guoyazhou/GAMMA_github/gamma-script/scripts/L2G/MAGIC_data/QTL_lite_besd/besd/eQTL_ROSMAP_snRNA_subtype_Oli.11	FALSE
eQTL_ROSMAP_snRNA_subtype_Mac	/storage/yangjianLab/guoyazhou/GAMMA_github/gamma-script/scripts/L2G/MAGIC_data/QTL_lite_besd/besd/eQTL_ROSMAP_snRNA_subtype_Mac	FALSE
eQTL_ROSMAP_snRNA_subtype_Peri.2	/storage/yangjianLab/guoyazhou/GAMMA_github/gamma-script/scripts/L2G/MAGIC_data/QTL_lite_besd/besd/eQTL_ROSMAP_snRNA_subtype_Peri.2	FALSE
eQTL_TCLSIH	/storage/yangjianLab/guoyazhou/GAMMA_github/gamma-script/scripts/L2G/MAGIC_data/QTL_lite_besd/besd/eQTL_TCLSIH	TRUE