sQTL_Microglia	/storage/yangjianLab/guoyazhou/GAMMA_github/gamma-script/scripts/L2G/MAGIC_data/QTL_lite_besd/besd/sQTL_Microglia	FALSE
sQTL_INTERVAL	/storage/yangjianLab/guoyazhou/GAMMA_github/gamma-script/scripts/L2G/MAGIC_data/QTL_lite_besd/besd/sQTL_INTERVAL	TRUE
sQTL_BrainMeta	/storage/yangjianLab/guoyazhou/GAMMA_github/gamma-script/scripts/L2G/MAGIC_data/QTL_lite_besd/besd/sQTL_BrainMeta	TRUE
sQTL_PEC_Tri1	/storage/yangjianLab/guoyazhou/GAMMA_github/gamma-script/scripts/L2G/MAGIC_data/QTL_lite_besd/besd/sQTL_PEC_Tri1	TRUE
sQTL_PEC_Tri2	/storage/yangjianLab/guoyazhou/GAMMA_github/gamma-script/scripts/L2G/MAGIC_data/QTL_lite_besd/besd/sQTL_PEC_Tri2	TRUE
sQTL_PEC_isoQTL_Tri1	/storage/yangjianLab/guoyazhou/GAMMA_github/gamma-script/scripts/L2G/MAGIC_data/QTL_lite_besd/besd/sQTL_PEC_isoQTL_Tri1	TRUE
sQTL_PEC_isoQTL_Tri2	/storage/yangjianLab/guoyazhou/GAMMA_github/gamma-script/scripts/L2G/MAGIC_data/QTL_lite_besd/besd/sQTL_PEC_isoQTL_Tri2	TRUE
sQTL_GTEx_Adipose_Subcutaneous	/storage/yangjianLab/guoyazhou/GAMMA_github/gamma-script/scripts/L2G/MAGIC_data/QTL_lite_besd/besd/sQTL_GTEx_Adipose_Subcutaneous	TRUE
sQTL_GTEx_Adipose_Visceral_Omentum	/storage/yangjianLab/guoyazhou/GAMMA_github/gamma-script/scripts/L2G/MAGIC_data/QTL_lite_besd/besd/sQTL_GTEx_Adipose_Visceral_Omentum	TRUE
sQTL_GTEx_Adrenal_Gland	/storage/yangjianLab/guoyazhou/GAMMA_github/gamma-script/scripts/L2G/MAGIC_data/QTL_lite_besd/besd/sQTL_GTEx_Adrenal_Gland	TRUE
sQTL_GTEx_Artery_Aorta	/storage/yangjianLab/guoyazhou/GAMMA_github/gamma-script/scripts/L2G/MAGIC_data/QTL_lite_besd/besd/sQTL_GTEx_Artery_Aorta	TRUE
sQTL_GTEx_Artery_Coronary	/storage/yangjianLab/guoyazhou/GAMMA_github/gamma-script/scripts/L2G/MAGIC_data/QTL_lite_besd/besd/sQTL_GTEx_Artery_Coronary	TRUE
sQTL_GTEx_Artery_Tibial	/storage/yangjianLab/guoyazhou/GAMMA_github/gamma-script/scripts/L2G/MAGIC_data/QTL_lite_besd/besd/sQTL_GTEx_Artery_Tibial	TRUE
sQTL_GTEx_Brain_Amygdala	/storage/yangjianLab/guoyazhou/GAMMA_github/gamma-script/scripts/L2G/MAGIC_data/QTL_lite_besd/besd/sQTL_GTEx_Brain_Amygdala	TRUE
sQTL_GTEx_Brain_Anterior_cingulate_cortex_BA24	/storage/yangjianLab/guoyazhou/GAMMA_github/gamma-script/scripts/L2G/MAGIC_data/QTL_lite_besd/besd/sQTL_GTEx_Brain_Anterior_cingulate_cortex_BA24	TRUE
sQTL_GTEx_Brain_Caudate_basal_ganglia	/storage/yangjianLab/guoyazhou/GAMMA_github/gamma-script/scripts/L2G/MAGIC_data/QTL_lite_besd/besd/sQTL_GTEx_Brain_Caudate_basal_ganglia	TRUE
sQTL_GTEx_Brain_Cerebellar_Hemisphere	/storage/yangjianLab/guoyazhou/GAMMA_github/gamma-script/scripts/L2G/MAGIC_data/QTL_lite_besd/besd/sQTL_GTEx_Brain_Cerebellar_Hemisphere	TRUE
sQTL_GTEx_Brain_Cerebellum	/storage/yangjianLab/guoyazhou/GAMMA_github/gamma-script/scripts/L2G/MAGIC_data/QTL_lite_besd/besd/sQTL_GTEx_Brain_Cerebellum	TRUE
sQTL_GTEx_Brain_Cortex	/storage/yangjianLab/guoyazhou/GAMMA_github/gamma-script/scripts/L2G/MAGIC_data/QTL_lite_besd/besd/sQTL_GTEx_Brain_Cortex	TRUE
sQTL_GTEx_Brain_Frontal_Cortex_BA9	/storage/yangjianLab/guoyazhou/GAMMA_github/gamma-script/scripts/L2G/MAGIC_data/QTL_lite_besd/besd/sQTL_GTEx_Brain_Frontal_Cortex_BA9	TRUE
sQTL_GTEx_Brain_Hippocampus	/storage/yangjianLab/guoyazhou/GAMMA_github/gamma-script/scripts/L2G/MAGIC_data/QTL_lite_besd/besd/sQTL_GTEx_Brain_Hippocampus	TRUE
sQTL_GTEx_Brain_Hypothalamus	/storage/yangjianLab/guoyazhou/GAMMA_github/gamma-script/scripts/L2G/MAGIC_data/QTL_lite_besd/besd/sQTL_GTEx_Brain_Hypothalamus	TRUE
sQTL_GTEx_Brain_Nucleus_accumbens_basal_ganglia	/storage/yangjianLab/guoyazhou/GAMMA_github/gamma-script/scripts/L2G/MAGIC_data/QTL_lite_besd/besd/sQTL_GTEx_Brain_Nucleus_accumbens_basal_ganglia	TRUE
sQTL_GTEx_Brain_Putamen_basal_ganglia	/storage/yangjianLab/guoyazhou/GAMMA_github/gamma-script/scripts/L2G/MAGIC_data/QTL_lite_besd/besd/sQTL_GTEx_Brain_Putamen_basal_ganglia	TRUE
sQTL_GTEx_Brain_Spinal_cord_cervical_c-1	/storage/yangjianLab/guoyazhou/GAMMA_github/gamma-script/scripts/L2G/MAGIC_data/QTL_lite_besd/besd/sQTL_GTEx_Brain_Spinal_cord_cervical_c-1	TRUE
sQTL_GTEx_Brain_Substantia_nigra	/storage/yangjianLab/guoyazhou/GAMMA_github/gamma-script/scripts/L2G/MAGIC_data/QTL_lite_besd/besd/sQTL_GTEx_Brain_Substantia_nigra	TRUE
sQTL_GTEx_Breast_Mammary_Tissue	/storage/yangjianLab/guoyazhou/GAMMA_github/gamma-script/scripts/L2G/MAGIC_data/QTL_lite_besd/besd/sQTL_GTEx_Breast_Mammary_Tissue	TRUE
sQTL_GTEx_Cells_Cultured_fibroblasts	/storage/yangjianLab/guoyazhou/GAMMA_github/gamma-script/scripts/L2G/MAGIC_data/QTL_lite_besd/besd/sQTL_GTEx_Cells_Cultured_fibroblasts	TRUE
sQTL_GTEx_Cells_EBV-transformed_lymphocytes	/storage/yangjianLab/guoyazhou/GAMMA_github/gamma-script/scripts/L2G/MAGIC_data/QTL_lite_besd/besd/sQTL_GTEx_Cells_EBV-transformed_lymphocytes	TRUE
sQTL_GTEx_Colon_Sigmoid	/storage/yangjianLab/guoyazhou/GAMMA_github/gamma-script/scripts/L2G/MAGIC_data/QTL_lite_besd/besd/sQTL_GTEx_Colon_Sigmoid	TRUE
sQTL_GTEx_Colon_Transverse	/storage/yangjianLab/guoyazhou/GAMMA_github/gamma-script/scripts/L2G/MAGIC_data/QTL_lite_besd/besd/sQTL_GTEx_Colon_Transverse	TRUE
sQTL_GTEx_Esophagus_Gastroesophageal_Junction	/storage/yangjianLab/guoyazhou/GAMMA_github/gamma-script/scripts/L2G/MAGIC_data/QTL_lite_besd/besd/sQTL_GTEx_Esophagus_Gastroesophageal_Junction	TRUE
sQTL_GTEx_Esophagus_Mucosa	/storage/yangjianLab/guoyazhou/GAMMA_github/gamma-script/scripts/L2G/MAGIC_data/QTL_lite_besd/besd/sQTL_GTEx_Esophagus_Mucosa	TRUE
sQTL_GTEx_Esophagus_Muscularis	/storage/yangjianLab/guoyazhou/GAMMA_github/gamma-script/scripts/L2G/MAGIC_data/QTL_lite_besd/besd/sQTL_GTEx_Esophagus_Muscularis	TRUE
sQTL_GTEx_Heart_Atrial_Appendage	/storage/yangjianLab/guoyazhou/GAMMA_github/gamma-script/scripts/L2G/MAGIC_data/QTL_lite_besd/besd/sQTL_GTEx_Heart_Atrial_Appendage	TRUE
sQTL_GTEx_Heart_Left_Ventricle	/storage/yangjianLab/guoyazhou/GAMMA_github/gamma-script/scripts/L2G/MAGIC_data/QTL_lite_besd/besd/sQTL_GTEx_Heart_Left_Ventricle	TRUE
sQTL_GTEx_Kidney_Cortex	/storage/yangjianLab/guoyazhou/GAMMA_github/gamma-script/scripts/L2G/MAGIC_data/QTL_lite_besd/besd/sQTL_GTEx_Kidney_Cortex	TRUE
sQTL_GTEx_Liver	/storage/yangjianLab/guoyazhou/GAMMA_github/gamma-script/scripts/L2G/MAGIC_data/QTL_lite_besd/besd/sQTL_GTEx_Liver	TRUE
sQTL_GTEx_Lung	/storage/yangjianLab/guoyazhou/GAMMA_github/gamma-script/scripts/L2G/MAGIC_data/QTL_lite_besd/besd/sQTL_GTEx_Lung	TRUE
sQTL_GTEx_Minor_Salivary_Gland	/storage/yangjianLab/guoyazhou/GAMMA_github/gamma-script/scripts/L2G/MAGIC_data/QTL_lite_besd/besd/sQTL_GTEx_Minor_Salivary_Gland	TRUE
sQTL_GTEx_Muscle_Skeletal	/storage/yangjianLab/guoyazhou/GAMMA_github/gamma-script/scripts/L2G/MAGIC_data/QTL_lite_besd/besd/sQTL_GTEx_Muscle_Skeletal	TRUE
sQTL_GTEx_Nerve_Tibial	/storage/yangjianLab/guoyazhou/GAMMA_github/gamma-script/scripts/L2G/MAGIC_data/QTL_lite_besd/besd/sQTL_GTEx_Nerve_Tibial	TRUE
sQTL_GTEx_Ovary	/storage/yangjianLab/guoyazhou/GAMMA_github/gamma-script/scripts/L2G/MAGIC_data/QTL_lite_besd/besd/sQTL_GTEx_Ovary	TRUE
sQTL_GTEx_Pancreas	/storage/yangjianLab/guoyazhou/GAMMA_github/gamma-script/scripts/L2G/MAGIC_data/QTL_lite_besd/besd/sQTL_GTEx_Pancreas	TRUE
sQTL_GTEx_Pituitary	/storage/yangjianLab/guoyazhou/GAMMA_github/gamma-script/scripts/L2G/MAGIC_data/QTL_lite_besd/besd/sQTL_GTEx_Pituitary	TRUE
sQTL_GTEx_Prostate	/storage/yangjianLab/guoyazhou/GAMMA_github/gamma-script/scripts/L2G/MAGIC_data/QTL_lite_besd/besd/sQTL_GTEx_Prostate	TRUE
sQTL_GTEx_Skin_Not_Sun_Exposed_Suprapubic	/storage/yangjianLab/guoyazhou/GAMMA_github/gamma-script/scripts/L2G/MAGIC_data/QTL_lite_besd/besd/sQTL_GTEx_Skin_Not_Sun_Exposed_Suprapubic	TRUE
sQTL_GTEx_Skin_Sun_Exposed_Lower_leg	/storage/yangjianLab/guoyazhou/GAMMA_github/gamma-script/scripts/L2G/MAGIC_data/QTL_lite_besd/besd/sQTL_GTEx_Skin_Sun_Exposed_Lower_leg	TRUE
sQTL_GTEx_Small_Intestine_Terminal_Ileum	/storage/yangjianLab/guoyazhou/GAMMA_github/gamma-script/scripts/L2G/MAGIC_data/QTL_lite_besd/besd/sQTL_GTEx_Small_Intestine_Terminal_Ileum	TRUE
sQTL_GTEx_Spleen	/storage/yangjianLab/guoyazhou/GAMMA_github/gamma-script/scripts/L2G/MAGIC_data/QTL_lite_besd/besd/sQTL_GTEx_Spleen	TRUE
sQTL_GTEx_Stomach	/storage/yangjianLab/guoyazhou/GAMMA_github/gamma-script/scripts/L2G/MAGIC_data/QTL_lite_besd/besd/sQTL_GTEx_Stomach	TRUE
sQTL_GTEx_Testis	/storage/yangjianLab/guoyazhou/GAMMA_github/gamma-script/scripts/L2G/MAGIC_data/QTL_lite_besd/besd/sQTL_GTEx_Testis	TRUE
sQTL_GTEx_Thyroid	/storage/yangjianLab/guoyazhou/GAMMA_github/gamma-script/scripts/L2G/MAGIC_data/QTL_lite_besd/besd/sQTL_GTEx_Thyroid	TRUE
sQTL_GTEx_Uterus	/storage/yangjianLab/guoyazhou/GAMMA_github/gamma-script/scripts/L2G/MAGIC_data/QTL_lite_besd/besd/sQTL_GTEx_Uterus	TRUE
sQTL_GTEx_Vagina	/storage/yangjianLab/guoyazhou/GAMMA_github/gamma-script/scripts/L2G/MAGIC_data/QTL_lite_besd/besd/sQTL_GTEx_Vagina	TRUE
sQTL_GTEx_Whole_Blood	/storage/yangjianLab/guoyazhou/GAMMA_github/gamma-script/scripts/L2G/MAGIC_data/QTL_lite_besd/besd/sQTL_GTEx_Whole_Blood	TRUE



sQTL_TCLSIH_LeafCutter	/storage/yangjianLab/guoyazhou/GAMMA_github/gamma-script/scripts/L2G/MAGIC_data/QTL_lite_besd/besd/sQTL_TCLSIH_LeafCutter	TRUE
sQTL_TCLSIH_THISTLE	/storage/yangjianLab/guoyazhou/GAMMA_github/gamma-script/scripts/L2G/MAGIC_data/QTL_lite_besd/besd/sQTL_TCLSIH_THISTLE	TRUE
sQTL_isoQTL_TCLSIH	/storage/yangjianLab/guoyazhou/GAMMA_github/gamma-script/scripts/L2G/MAGIC_data/QTL_lite_besd/besd/isoQTL_TCLSIH	TRUE
sQTL_T1KMultiome_SR_GENCODE_THISTLE	/storage/yangjianLab/guoyazhou/GAMMA_github/gamma-script/scripts/L2G/MAGIC_data/QTL_lite_besd/besd/sQTL_T1KMultiome_SR_GENCODE_THISTLE	TRUE
sQTL_T1KMultiome_ONT_GENCODE_THISTLE	/storage/yangjianLab/guoyazhou/GAMMA_github/gamma-script/scripts/L2G/MAGIC_data/QTL_lite_besd/besd/sQTL_T1KMultiome_ONT_GENCODE_THISTLE	TRUE
sQTL_T1KMultiome_SR_GeneNanotator_THISTLE	/storage/yangjianLab/guoyazhou/GAMMA_github/gamma-script/scripts/L2G/MAGIC_data/QTL_lite_besd/besd/sQTL_T1KMultiome_SR_GeneNanotator_THISTLE	TRUE
sQTL_T1KMultiome_ONT_GeneNanotator_THISTLE	/storage/yangjianLab/guoyazhou/GAMMA_github/gamma-script/scripts/L2G/MAGIC_data/QTL_lite_besd/besd/sQTL_T1KMultiome_ONT_GeneNanotator_THISTLE	TRUE
sQTL_isoQTL_T1KMultiome_SR_GENCODE	/storage/yangjianLab/guoyazhou/GAMMA_github/gamma-script/scripts/L2G/MAGIC_data/QTL_lite_besd/besd/isoQTL_T1KMultiome_SR_GENCODE	TRUE
sQTL_isoQTL_T1KMultiome_ONT_GENCODE	/storage/yangjianLab/guoyazhou/GAMMA_github/gamma-script/scripts/L2G/MAGIC_data/QTL_lite_besd/besd/isoQTL_T1KMultiome_ONT_GENCODE	TRUE
sQTL_isoQTL_T1KMultiome_SR_GeneNanotator	/storage/yangjianLab/guoyazhou/GAMMA_github/gamma-script/scripts/L2G/MAGIC_data/QTL_lite_besd/besd/isoQTL_T1KMultiome_SR_GeneNanotator	TRUE
sQTL_isoQTL_T1KMultiome_ONT_GeneNanotator	/storage/yangjianLab/guoyazhou/GAMMA_github/gamma-script/scripts/L2G/MAGIC_data/QTL_lite_besd/besd/isoQTL_T1KMultiome_ONT_GeneNanotator	TRUE